"record_code","tag_code_or_release_id","brood_year","hatchery_location_name","cwt_1st_mark_count","cwt_2nd_mark_count","non_cwt_1st_mark_count","non_cwt_2nd_mark_count","Total_Released","Phi"
"T","601020809",2016,"FEATHER R HATCHERY",2700,0,0,0,2700,1
"T","601020901",2016,"FEATHER R HATCHERY",4969,0,0,0,4969,1
"T","60572",2013,"FEATHER R HATCHERY",99354,0,105,633,100092,0.992626783359309
"T","62768",2002,"FEATHER R HATCHERY",54493,0,1112,0,55605,0.980001798399424
"T","60429",2011,"FEATHER R HATCHERY",240887,0,533,0,241420,0.997792229309916
"T","60565",2013,"FEATHER R HATCHERY",388174,1745,3927,1190884,1584730,0.244946457756211
"T","60394",2011,"FEATHER R HATCHERY",394966,0,436,1188990,1584392,0.24928553034855
"T","60566",2013,"FEATHER R HATCHERY",379254,1264,5479,1164127,1550124,0.244660427165827
"T","61457",2017,"FEATHER R HATCHERY",82425,0,742,250313,333480,0.247166246851385
"T","62294",2020,"FEATHER R HATCHERY",82836,185,185,251617,334823,0.247402358858262
"T","61458",2017,"FEATHER R HATCHERY",84219,0,93,253424,337736,0.249363408105739
"T","62295",2020,"FEATHER R HATCHERY",85502,0,258242,0,343744,0.248737432507913
"T","62296",2020,"FEATHER R HATCHERY",85092,0,381,257926,343399,0.247793383207289
"T","60456",2017,"FEATHER R HATCHERY",35309,0,39,106312,141660,0.249251729493153
"T","61992",2018,"FEATHER R HATCHERY",82703,0,250385,0,333088,0.248291742722644
"T","60392",2011,"FEATHER R HATCHERY",389500,0,392,1173858,1563750,0.249080735411671
"T","62297",2020,"FEATHER R HATCHERY",85856,96,96,259569,345617,0.248413706501706
"T","62343",2020,"FEATHER R HATCHERY",241688,0,1897,737944,981529,0.24623622939312
"T","62344",2020,"FEATHER R HATCHERY",247437,560,3356,767084,1018437,0.242957590896639
"T","60393",2011,"FEATHER R HATCHERY",391022,0,1178078,0,1569100,0.249201453062265
"T","60391",2011,"FEATHER R HATCHERY",383701,425,812,1159212,1544150,0.248486869798918
"T","60653",2017,"FEATHER R HATCHERY",999026,0,3009404,0,4008430,0.249231245150845
"T","69502",2011,"FEATHER R HATCHERY",99901,110,110,111,100232,0.996697661425493
"T","61462",2017,"FEATHER R HATCHERY",83029,108,250063,0,333200,0.249186674669868
"T","61456",2017,"FEATHER R HATCHERY",83845,0,252785,0,336630,0.249071681074176
"T","68735",2011,"FEATHER R HATCHERY",16680,37,18,0,16735,0.996713474753511
"T","68676",2017,"FEATHER R HATCHERY",79815,0,2020,246705,328540,0.242938454982651
"T","61459",2017,"FEATHER R HATCHERY",83612,92,184,252712,336600,0.248401663695781
"T","62371",2020,"FEATHER R HATCHERY",16859,43,50959,0,67861,0.248434299524027
"T","62299",2020,"FEATHER R HATCHERY",84890,95,190,256813,341988,0.248225083921073
"T","61460",2017,"FEATHER R HATCHERY",78701,0,440,237808,316949,0.248308087421005
"T","61461",2017,"FEATHER R HATCHERY",83283,0,248477,0,331760,0.25103387991319
"T","608000807",2012,"FEATHER R HATCHERY",10080,0,0,0,10080,1
"T","62340",2020,"FEATHER R HATCHERY",85890,0,258278,0,344168,0.249558355221868
"T","60446",2013,"FEATHER R HATCHERY",4350,10,166,10,4536,0.958994708994709
"T","61463",2017,"FEATHER R HATCHERY",83053,0,251040,0,334093,0.2485924577887
"T","62341",2020,"FEATHER R HATCHERY",85757,0,480,259439,345676,0.248084911882804
"T","60452",2013,"FEATHER R HATCHERY",30090,70,1151,70,31381,0.958860456964405
"T","62342",2020,"FEATHER R HATCHERY",86117,96,259753,0,345966,0.248917523687299
"T","61464",2017,"FEATHER R HATCHERY",82470,216,1008,253856,337550,0.244319360094801
"T","60975",2016,"FEATHER R HATCHERY",131874,0,397038,0,528912,0.249330701515564
"T","62298",2020,"FEATHER R HATCHERY",84614,95,285,258194,343188,0.2465529097754
"T","62376",2020,"FEATHER R HATCHERY",30348,76,91639,0,122063,0.248625709674512
"T","60737",2015,"FEATHER R HATCHERY",249371,886,2362,763074,1015693,0.245518084696852
"T","62345",2020,"FEATHER R HATCHERY",258481,0,788641,0,1047122,0.246848982258037
"T","63820",1994,"FEATHER R HATCHERY",40942,0,0,0,40942,1
"T","62769",2002,"FEATHER R HATCHERY",54152,0,1389,0,55541,0.974991447759313
"T","62770",2002,"FEATHER R HATCHERY",51748,0,1327,0,53075,0.974997644842204
"T","601080800",2002,"FEATHER R HATCHERY",24362,0,1418,0,25780,0.94499612102405
"T","601020904",2015,"FEATHER R HATCHERY",47310,0,0,0,47310,1
"T","62771",2002,"FEATHER R HATCHERY",52105,0,1344,0,53449,0.974854534228891
"T","62772",2002,"FEATHER R HATCHERY",52675,0,1351,0,54026,0.97499352163773
"T","62773",2002,"FEATHER R HATCHERY",55625,0,1426,0,57051,0.97500482024855
"T","62774",2002,"FEATHER R HATCHERY",53377,0,1369,0,54746,0.974993606838856
"T","62775",2002,"FEATHER R HATCHERY",55611,0,1426,0,57037,0.974998685064081
"T","62776",2002,"FEATHER R HATCHERY",50704,0,1300,0,52004,0.975001922929005
"T","62779",2002,"FEATHER R HATCHERY",24813,0,1306,0,26119,0.949998085684751
"T","62780",2002,"FEATHER R HATCHERY",25025,0,1317,0,26342,0.950003796218966
"T","62781",2002,"FEATHER R HATCHERY",24938,0,771,0,25709,0.970010502158777
"T","601020905",2015,"FEATHER R HATCHERY",47661,0,0,0,47661,1
"T","62553",1995,"FEATHER R HATCHERY",51749,0,0,0,51749,1
"T","60967",2016,"FEATHER R HATCHERY",507985,567,567,0,509119,0.997772622903486
"T","60976",2016,"FEATHER R HATCHERY",130905,0,389368,0,520273,0.251608290262997
"T","60977",2016,"FEATHER R HATCHERY",131737,146,398897,0,530780,0.248195109084743
"T","601060801",1998,"FEATHER R HATCHERY",28125,0,0,0,28125,1
"T","60655",2017,"FEATHER R HATCHERY",497572,0,548,1499088,1997208,0.249133790771918
"T","61980",2018,"FEATHER R HATCHERY",248302,1285,642,750911,1001140,0.248019258045828
"T","61986",2018,"FEATHER R HATCHERY",81780,424,250783,0,332987,0.245595173385147
"T","601080808",2002,"FEATHER R HATCHERY",53133,0,267,0,53400,0.995
"T","601080809",2002,"FEATHER R HATCHERY",51964,0,791,0,52755,0.985006160553502
"T","601080900",2002,"FEATHER R HATCHERY",51386,0,1318,0,52704,0.97499241044323
"T","601080901",2002,"FEATHER R HATCHERY",51388,0,258,0,51646,0.995004453394261
"T","60968",2016,"FEATHER R HATCHERY",253832,1716,1430,286,257264,0.986659618135456
"T","62537",1995,"FEATHER R HATCHERY",33249,0,0,0,33249,1
"T","60792",2016,"FEATHER R HATCHERY",43232,0,130165,0,173397,0.249323806063542
"T","60969",2016,"FEATHER R HATCHERY",260322,1760,1467,293,263842,0.986658682090039
"T","60970",2016,"FEATHER R HATCHERY",236755,1630,5704,773219,1017308,0.232726961746099
"T","60972",2016,"FEATHER R HATCHERY",241500,0,621000,0,862500,0.28
"T","62536",1995,"FEATHER R HATCHERY",35593,0,0,0,35593,1
"T","62764",2002,"FEATHER R HATCHERY",53275,0,2510,0,55785,0.955005825938873
"T","62765",2002,"FEATHER R HATCHERY",53435,0,2518,0,55953,0.954997944703591
"T","62766",2002,"FEATHER R HATCHERY",53601,0,2526,0,56127,0.954994922229943
"T","62767",2002,"FEATHER R HATCHERY",54971,0,1122,0,56093,0.979997504144902
"T","62540",1995,"FEATHER R HATCHERY",12404,0,0,0,12404,1
"T","63817",1993,"FEATHER R HATCHERY",28288,0,0,0,28288,1
"T","60935",2016,"FEATHER R HATCHERY",30430,0,91428,0,121858,0.249716883585813
"T","60938",2016,"FEATHER R HATCHERY",51058,0,153831,0,204889,0.249198346421721
"T","62685",2002,"FEATHER R HATCHERY",54186,0,1106,0,55292,0.979997106272155
"T","62704",2002,"FEATHER R HATCHERY",79302,0,1618,0,80920,0.980004943153732
"T","62705",2002,"FEATHER R HATCHERY",79201,0,1616,0,80817,0.980004207035648
"T","68685",2011,"FEATHER R HATCHERY",98947,0,111,112,99170,0.997751336089543
"T","62090",2001,"FEATHER R HATCHERY",263768,0,221050,6832,491650,0.536495474422862
"T","62091",2001,"FEATHER R HATCHERY",264738,0,221050,6962,492750,0.537266362252664
"T","601070004",2001,"FEATHER R HATCHERY",23922,0,251,0,24173,0.989616514292806
"T","61979",2018,"FEATHER R HATCHERY",248808,0,624,752698,1002130,0.248279165377745
"T","61978",2018,"FEATHER R HATCHERY",247184,644,749659,0,997487,0.247806738333432
"T","61988",2018,"FEATHER R HATCHERY",81677,210,1051,249749,332687,0.245507038146967
"T","61982",2018,"FEATHER R HATCHERY",77376,3094,251910,0,332380,0.232793790240087
"T","61983",2018,"FEATHER R HATCHERY",79709,818,273,247989,328789,0.24243207649891
"T","61984",2018,"FEATHER R HATCHERY",80717,658,252459,0,333834,0.241787834672322
"T","61985",2018,"FEATHER R HATCHERY",81711,0,601,247974,330286,0.247394682184531
"T","61993",2018,"FEATHER R HATCHERY",53366,0,161124,0,214490,0.248804140053149
"T","61991",2018,"FEATHER R HATCHERY",80470,0,1159,243513,325142,0.24749186509279
"T","61990",2018,"FEATHER R HATCHERY",81666,0,1210,250047,332923,0.245299964255999
"T","61989",2018,"FEATHER R HATCHERY",82145,1031,250344,0,333520,0.246297073638762
"T","61981",2018,"FEATHER R HATCHERY",83024,426,250928,0,334378,0.248293847083241
"T","601070005",2001,"FEATHER R HATCHERY",25744,0,270,0,26014,0.989620973322057
"T","601070006",2001,"FEATHER R HATCHERY",26380,0,561,0,26941,0.979176719498163
"T","601070007",2001,"FEATHER R HATCHERY",24566,0,523,0,25089,0.979154211008809
"T","601070600",2001,"FEATHER R HATCHERY",9664,0,224,0,9888,0.977346278317152
"T","601070601",2001,"FEATHER R HATCHERY",10375,0,240,0,10615,0.977390485162506
"T","601070602",2001,"FEATHER R HATCHERY",9839,0,228,0,10067,0.977351743319758
"T","601070603",2001,"FEATHER R HATCHERY",10838,0,251,0,11089,0.977364956262963
"T","601070604",2001,"FEATHER R HATCHERY",8937,0,207,0,9144,0.977362204724409
"T","601070605",2001,"FEATHER R HATCHERY",9652,0,48,0,9700,0.995051546391753
"T","601070606",2001,"FEATHER R HATCHERY",10426,0,52,0,10478,0.995037220843672
"T","601070607",2001,"FEATHER R HATCHERY",10389,0,52,0,10441,0.995019634134661
"T","601070608",2001,"FEATHER R HATCHERY",11192,0,56,0,11248,0.9950213371266
"T","601070609",2001,"FEATHER R HATCHERY",8751,0,44,0,8795,0.994997157475839
"T","601070700",2001,"FEATHER R HATCHERY",26104,0,617,0,26721,0.976909546798398
"T","601070701",2001,"FEATHER R HATCHERY",25728,0,606,0,26334,0.976987924356345
"T","601070702",2001,"FEATHER R HATCHERY",25462,0,707,0,26169,0.972983300852153
"T","601070703",2001,"FEATHER R HATCHERY",25276,0,701,0,25977,0.973014589829465
"T","601070704",2001,"FEATHER R HATCHERY",24138,0,1321,0,25459,0.948112651714521
"T","601070705",2001,"FEATHER R HATCHERY",24319,0,1331,0,25650,0.948109161793372
"T","61987",2018,"FEATHER R HATCHERY",81975,419,209,248142,330745,0.24784955176949
"T","601060711",1998,"FEATHER R HATCHERY",25000,0,0,0,25000,1
"T","62695",2001,"FEATHER R HATCHERY",44563,0,541,0,45104,0.988005498403689
"T","62696",2001,"FEATHER R HATCHERY",44789,0,682,0,45471,0.985001429482527
"T","62699",2001,"FEATHER R HATCHERY",43789,0,1123,0,44912,0.974995546847168
"T","62724",2001,"FEATHER R HATCHERY",22883,0,587,0,23470,0.974989348103963
"T","62725",2001,"FEATHER R HATCHERY",22436,0,575,0,23011,0.975011950806136
"T","62735",2001,"FEATHER R HATCHERY",106870,0,3305,0,110175,0.970002269117313
"T","62736",2001,"FEATHER R HATCHERY",106336,0,3289,0,109625,0.96999771949829
"T","62737",2001,"FEATHER R HATCHERY",107348,0,3853,0,111201,0.965351031015908
"T","62738",2001,"FEATHER R HATCHERY",105753,0,3796,0,109549,0.965348839332171
"T","601060710",1998,"FEATHER R HATCHERY",26680,0,0,0,26680,1
"T","601061104",1999,"FEATHER R HATCHERY",100901,0,4810,0,105711,0.954498585766855
"T","601061108",1999,"FEATHER R HATCHERY",0,0,0,0,0,NA
"T","601060709",1998,"FEATHER R HATCHERY",26262,0,0,0,26262,1
"T","601060802",1998,"FEATHER R HATCHERY",26666,0,0,0,26666,1
"T","601060804",1998,"FEATHER R HATCHERY",25886,0,0,0,25886,1
"T","62534",1995,"FEATHER R HATCHERY",34078,0,0,0,34078,1
"T","63815",1993,"FEATHER R HATCHERY",54467,0,0,0,54467,1
"T","601061206",2000,"FEATHER R HATCHERY",26077,0,641,0,26718,0.976008683284677
"T","601061207",2000,"FEATHER R HATCHERY",25679,0,631,0,26310,0.976016723679209
"T","601061208",2000,"FEATHER R HATCHERY",26280,0,646,0,26926,0.976008319096784
"T","601061209",2000,"FEATHER R HATCHERY",25947,0,638,0,26585,0.976001504607862
"T","601061210",2000,"FEATHER R HATCHERY",27042,0,665,0,27707,0.975998845057206
"T","601061211",2000,"FEATHER R HATCHERY",25574,0,629,0,26203,0.975995115063161
"T","601070205",2000,"FEATHER R HATCHERY",9149,0,405,0,9554,0.957609378270881
"T","601070206",2000,"FEATHER R HATCHERY",9507,0,421,0,9928,0.9575946817083
"T","601070203",2000,"FEATHER R HATCHERY",9526,0,376,0,9902,0.962027873156938
"T","601070204",2000,"FEATHER R HATCHERY",9166,0,362,0,9528,0.9620067170445
"T","601070207",2000,"FEATHER R HATCHERY",9508,0,421,0,9929,0.957598952563199
"T","601070208",2000,"FEATHER R HATCHERY",9359,0,414,0,9773,0.957638391486749
"T","601070209",2000,"FEATHER R HATCHERY",9000,0,399,0,9399,0.957548675390999
"T","601070300",2000,"FEATHER R HATCHERY",10241,0,156,0,10397,0.984995671828412
"T","601070301",2000,"FEATHER R HATCHERY",9915,0,151,0,10066,0.984999006556726
"T","601070302",2000,"FEATHER R HATCHERY",9806,0,149,0,9955,0.9850326469111
"T","601061212",2000,"FEATHER R HATCHERY",25464,0,626,0,26090,0.976006132617861
"T","601061213",2000,"FEATHER R HATCHERY",26921,0,662,0,27583,0.975999709966284
"T","601070000",2000,"FEATHER R HATCHERY",24556,0,759,0,25315,0.970017776022121
"T","601070001",2000,"FEATHER R HATCHERY",21924,0,678,0,22602,0.970002654632333
"T","601070002",2000,"FEATHER R HATCHERY",23271,0,1860,0,25131,0.925987823803271
"T","601070003",2000,"FEATHER R HATCHERY",22919,0,1832,0,24751,0.925982788574199
"T","62481",2005,"FEATHER R HATCHERY",57353,0,289,0,57642,0.994986294715659
"T","62482",2005,"FEATHER R HATCHERY",56689,0,0,0,56689,1
"T","62483",2005,"FEATHER R HATCHERY",56713,0,0,0,56713,1
"T","601070303",2000,"FEATHER R HATCHERY",9745,0,145,0,9890,0.985338725985844
"T","601070304",2000,"FEATHER R HATCHERY",9544,0,145,0,9689,0.985034575291568
"T","601070305",2000,"FEATHER R HATCHERY",10179,0,315,0,10494,0.969982847341338
"T","601070306",2000,"FEATHER R HATCHERY",9134,0,283,0,9417,0.969947966443666
"T","601070307",2000,"FEATHER R HATCHERY",10141,0,314,0,10455,0.969966523194644
"T","601070308",2000,"FEATHER R HATCHERY",8921,0,276,0,9197,0.969990214200283
"T","601070309",2000,"FEATHER R HATCHERY",9884,0,306,0,10190,0.969970559371933
"T","601070200",2000,"FEATHER R HATCHERY",9419,0,372,0,9791,0.962005923807578
"T","601070201",2000,"FEATHER R HATCHERY",9732,0,384,0,10116,0.962040332147094
"T","601070202",2000,"FEATHER R HATCHERY",9448,0,373,0,9821,0.962020160879748
"T","66203",1977,"FEATHER R HATCHERY",164766,0,18183,0,182949,0.900611645868521
"T","53829",1999,"FEATHER R HATCHERY",23582,0,780,0,24362,0.967982924226254
"T","62661",1999,"FEATHER R HATCHERY",0,0,0,0,0,NA
"T","62669",2000,"FEATHER R HATCHERY",32082,0,2194,0,34276,0.935990197222546
"T","62670",2000,"FEATHER R HATCHERY",31384,0,2146,0,33530,0.935997614076946
"T","62671",2000,"FEATHER R HATCHERY",31575,0,2159,0,33734,0.93599928855161
"T","62672",2000,"FEATHER R HATCHERY",42003,0,2872,0,44875,0.936
"T","62673",2000,"FEATHER R HATCHERY",46642,0,3189,0,49831,0.936003692480584
"T","62674",2000,"FEATHER R HATCHERY",47369,0,3239,0,50608,0.935998261144483
"T","62675",2000,"FEATHER R HATCHERY",42704,0,2920,0,45624,0.935998597229528
"T","62676",2000,"FEATHER R HATCHERY",44021,0,3010,0,47031,0.935999659798856
"T","62304",2005,"FEATHER R HATCHERY",26038,0,397,0,26435,0.984982031397768
"T","62309",2005,"FEATHER R HATCHERY",25919,0,877,0,26796,0.967271234512614
"T","62310",2005,"FEATHER R HATCHERY",13493,0,206,0,13699,0.984962406015038
"T","62311",2005,"FEATHER R HATCHERY",12854,0,196,0,13050,0.984980842911877
"T","62664",2000,"FEATHER R HATCHERY",202096,0,718675,732,921503,0.219311277337133
"T","62665",2000,"FEATHER R HATCHERY",142204,0,718675,1038,861917,0.164985723683371
"T","601060504",1997,"FEATHER R HATCHERY",15909,0,131,0,16040,0.991832917705736
"T","63119",1989,"FEATHER R HATCHERY",50143,0,3920,0,54063,0.927492000073988
"T","66240",1984,"FEATHER R HATCHERY",10887,0,1377,0,12264,0.887720156555773
"T","66260",1987,"FEATHER R HATCHERY",51904,0,1939,0,53843,0.963987890719314
"T","66224",1982,"FEATHER R HATCHERY",96706,0,5954,0,102660,0.942002727449834
"T","66259",1987,"FEATHER R HATCHERY",54997,0,2054,0,57051,0.963997125379047
"T","66257",1986,"FEATHER R HATCHERY",51836,0,842,0,52678,0.984016097801739
"T","601140103",1988,"FEATHER R HATCHERY",52907,0,1360,0,54267,0.974938728877587
"T","60448",2013,"FEATHER R HATCHERY",11791,0,0,0,11791,1
"T","60524",2013,"FEATHER R HATCHERY",100564,0,320,214,101098,0.994717996399533
"T","60525",2013,"FEATHER R HATCHERY",100227,0,0,0,100227,1
"T","60564",2013,"FEATHER R HATCHERY",528975,0,1589525,0,2118500,0.249693179136181
"T","60568",2013,"FEATHER R HATCHERY",96513,224,3693,224,100654,0.958859061736245
"T","62448",2005,"FEATHER R HATCHERY",57934,0,292,0,58226,0.994985058221413
"T","62449",2005,"FEATHER R HATCHERY",57718,0,291,0,58009,0.994983537037356
"T","62450",2005,"FEATHER R HATCHERY",57655,0,145,0,57800,0.997491349480969
"T","62451",2005,"FEATHER R HATCHERY",57768,0,0,0,57768,1
"T","62312",2005,"FEATHER R HATCHERY",13001,0,198,0,13199,0.984998863550269
"T","62313",2005,"FEATHER R HATCHERY",14260,0,218,0,14478,0.984942671639729
"T","62452",2005,"FEATHER R HATCHERY",58745,0,0,0,58745,1
"T","62453",2005,"FEATHER R HATCHERY",56776,0,0,0,56776,1
"T","62454",2005,"FEATHER R HATCHERY",57291,0,873,0,58164,0.984990715906746
"T","62455",2005,"FEATHER R HATCHERY",56298,0,858,0,57156,0.984988452655889
"T","62456",2005,"FEATHER R HATCHERY",57465,0,581,0,58046,0.989990697033387
"T","62477",2005,"FEATHER R HATCHERY",56719,0,573,0,57292,0.989998603644488
"T","B61404",1987,"FEATHER R HATCHERY",51274,0,3055,0,54329,0.943768521415818
"T","66238",1984,"FEATHER R HATCHERY",54457,0,384,0,54841,0.992997939497821
"T","B61403",1987,"FEATHER R HATCHERY",55861,0,2581,0,58442,0.955836555901578
"T","66254",1986,"FEATHER R HATCHERY",50521,0,3512,0,54033,0.935002683545241
"T","H60403",1982,"FEATHER R HATCHERY",48501,0,2553,0,51054,0.949994123868845
"T","63108",1988,"FEATHER R HATCHERY",50659,0,2169,0,52828,0.958942227606572
"T","66251",1985,"FEATHER R HATCHERY",47995,0,4516,0,52511,0.913998971644037
"T","62478",2005,"FEATHER R HATCHERY",58950,0,297,0,59247,0.99498708795382
"T","62479",2005,"FEATHER R HATCHERY",57395,0,289,0,57684,0.994989945218778
"T","52326",1998,"FEATHER R HATCHERY",25576,0,337,0,25913,0.98699494462239
"T","52327",1998,"FEATHER R HATCHERY",25518,0,336,0,25854,0.987003945230912
"T","66245",1984,"FEATHER R HATCHERY",48143,0,5016,0,53159,0.905641565868432
"T","66237",1983,"FEATHER R HATCHERY",23558,0,1292,0,24850,0.948008048289738
"T","66212",1979,"FEATHER R HATCHERY",79443,0,2457,0,81900,0.97
"T","66230",1982,"FEATHER R HATCHERY",43374,0,5636,0,49010,0.885003060599878
"T","B61408",1987,"FEATHER R HATCHERY",55265,0,289,0,55554,0.994797854339922
"T","65813",1977,"FEATHER R HATCHERY",97000,0,5820,0,102820,0.943396226415094
"T","62480",2005,"FEATHER R HATCHERY",58873,0,296,0,59169,0.994997380384999
"T","63109",1988,"FEATHER R HATCHERY",51760,0,524,0,52284,0.989977813480223
"T","65816",1978,"FEATHER R HATCHERY",77016,0,17459,0,94475,0.815199788303784
"T","66215",1980,"FEATHER R HATCHERY",78339,0,5536,0,83875,0.933997019374069
"T","63104",1987,"FEATHER R HATCHERY",54151,0,657,0,54808,0.988012698876076
"T","66206",1978,"FEATHER R HATCHERY",110122,0,22024,0,132146,0.833335855795862
"T","601140104",1988,"FEATHER R HATCHERY",48329,0,2386,0,50715,0.952952775313024
"T","601060301",1996,"FEATHER R HATCHERY",23772,0,3613,0,27385,0.868066459740734
"T","66222",1981,"FEATHER R HATCHERY",63221,0,6329,0,69550,0.909000718907261
"T","601060215",1996,"FEATHER R HATCHERY",24766,0,3764,0,28530,0.868068699614441
"T","66231",1983,"FEATHER R HATCHERY",18442,0,808,0,19250,0.958025974025974
"T","66209",1979,"FEATHER R HATCHERY",88700,0,4375,0,93075,0.952994896588772
"T","66253",1986,"FEATHER R HATCHERY",49781,0,3290,0,53071,0.938007574758343
"T","601060503",1997,"FEATHER R HATCHERY",15334,0,126,0,15460,0.991849935316947
"T","601110112",1988,"FEATHER R HATCHERY",29058,0,295,0,29353,0.98994991994004
"T","601140413",1994,"FEATHER R HATCHERY",50779,0,1090,0,51869,0.978985521216912
"T","601060207",1996,"FEATHER R HATCHERY",24812,0,2453,0,27265,0.910031175499725
"T","601140403",1993,"FEATHER R HATCHERY",50689,0,3419,0,54108,0.936811562061063
"T","601110110",1988,"FEATHER R HATCHERY",28708,0,559,0,29267,0.980899989749547
"T","60108",1975,"FEATHER R HATCHERY",84545,0,1725,0,86270,0.980004636606004
"T","65810",1976,"FEATHER R HATCHERY",71539,0,2213,0,73752,0.969994034060093
"T","66210",1979,"FEATHER R HATCHERY",88516,0,3592,0,92108,0.961002301645894
"T","H60402",1982,"FEATHER R HATCHERY",47518,0,2819,0,50337,0.943997457138884
"T","601060403",1998,"FEATHER R HATCHERY",49715,0,1803,0,51518,0.965002523389883
"T","H60303",1982,"FEATHER R HATCHERY",45775,0,3745,0,49520,0.924373990306947
"T","66239",1984,"FEATHER R HATCHERY",14731,0,1863,0,16594,0.887730505001808
"T","B61405",1987,"FEATHER R HATCHERY",51206,0,3051,0,54257,0.943767624453988
"T","65805",1988,"FEATHER R HATCHERY",37813,0,10228,0,48041,0.787098520014155
"T","63111",1988,"FEATHER R HATCHERY",51211,0,361,0,51572,0.993000077561467
"T","H60304",1982,"FEATHER R HATCHERY",48541,0,3044,0,51585,0.940990598042067
"T","66243",1985,"FEATHER R HATCHERY",98866,0,6199,0,105065,0.940998429543616
"T","66227",1983,"FEATHER R HATCHERY",62604,0,3996,0,66600,0.94
"T","66250",1987,"FEATHER R HATCHERY",99827,0,6146,0,105973,0.942004095382786
"T","B61402",1987,"FEATHER R HATCHERY",51388,0,2374,0,53762,0.955842416576764
"T","66256",1986,"FEATHER R HATCHERY",49083,0,2258,0,51341,0.956019555520929
"T","66241",1984,"FEATHER R HATCHERY",20551,0,2596,0,23147,0.887847237222966
"T","601061006",1999,"FEATHER R HATCHERY",26436,0,1101,0,27537,0.960017431092712
"T","601060404",1998,"FEATHER R HATCHERY",50864,0,1845,0,52709,0.96499649016297
"T","66223",1982,"FEATHER R HATCHERY",92693,0,7407,0,100100,0.926003996003996
"T","501020809",1999,"FEATHER R HATCHERY",26837,0,135,0,26972,0.994994809432004
"T","601140109",1989,"FEATHER R HATCHERY",52962,0,645,0,53607,0.987967989255135
"T","601060113",1995,"FEATHER R HATCHERY",50041,0,1028,0,51069,0.979870371458223
"T","601060208",1996,"FEATHER R HATCHERY",25049,0,2477,0,27526,0.910012351958149
"T","601110109",1988,"FEATHER R HATCHERY",27525,0,536,0,28061,0.980898756280959
"T","601140206",1990,"FEATHER R HATCHERY",52139,0,1725,0,53864,0.967974899747512
"T","601110111",1988,"FEATHER R HATCHERY",27758,0,281,0,28039,0.989978244587895
"T","63128",1990,"FEATHER R HATCHERY",49184,0,2076,0,51260,0.959500585251658
"T","601060109",1995,"FEATHER R HATCHERY",50820,0,516,0,51336,0.989948574100047
"T","601140408",1993,"FEATHER R HATCHERY",53810,0,1898,0,55708,0.965929489480865
"T","601060910",1998,"FEATHER R HATCHERY",51202,0,309,0,51511,0.994001281279727
"T","601060513",1997,"FEATHER R HATCHERY",37791,0,1169,0,38960,0.969994866529774
"T","62657",1999,"FEATHER R HATCHERY",103165,0,1571,0,104736,0.985000381912618
"T","601061105",1999,"FEATHER R HATCHERY",101115,0,3127,0,104242,0.970002494196197
"T","65858",1984,"FEATHER R HATCHERY",24305,0,1252,0,25557,0.951011464569394
"T","65822",1980,"FEATHER R HATCHERY",39871,0,4529,0,44400,0.897995495495496
"T","65834",1981,"FEATHER R HATCHERY",50989,0,411,0,51400,0.992003891050584
"T","65856",1984,"FEATHER R HATCHERY",22441,0,2600,0,25041,0.896170280739587
"T","65824",1980,"FEATHER R HATCHERY",45203,0,5294,0,50497,0.895162088836961
"T","65847",1983,"FEATHER R HATCHERY",40185,0,2565,0,42750,0.94
"T","65844",1982,"FEATHER R HATCHERY",39800,0,2904,0,42704,0.931997002622705
"T","66207",1979,"FEATHER R HATCHERY",88335,0,2920,0,91255,0.968001753328585
"T","66213",1980,"FEATHER R HATCHERY",97438,0,5562,0,103000,0.946
"T","65827",1980,"FEATHER R HATCHERY",30469,0,1047066,5195,1082730,0.0281409030875657
"T","65819",1979,"FEATHER R HATCHERY",42079,0,1006712,1212,1050003,0.040075123594885
"T","65833",1981,"FEATHER R HATCHERY",23876,0,1284,0,25160,0.948966613672496
"T","66204",1978,"FEATHER R HATCHERY",181028,0,36206,0,217234,0.833331798889677
"T","66216",1980,"FEATHER R HATCHERY",81393,0,8207,0,89600,0.908404017857143
"T","601060102",1993,"FEATHER R HATCHERY",100377,0,5657,0,106034,0.946649187996303
"T","601060101",1993,"FEATHER R HATCHERY",103558,0,2666,0,106224,0.974902093688809
"T","66201",1977,"FEATHER R HATCHERY",178998,0,11997,0,190995,0.937186837351763
"T","60103",1973,"FEATHER R HATCHERY",155086,0,21148,0,176234,0.880000453941918
"T","60302",1975,"FEATHER R HATCHERY",91887,0,4836,0,96723,0.950001550820384
"T","60102",1972,"FEATHER R HATCHERY",176523,0,24071,0,200594,0.880001395854313
"T","60101",1972,"FEATHER R HATCHERY",197792,0,26972,0,224764,0.879998576284458
"T","60105",1974,"FEATHER R HATCHERY",93675,0,8146,0,101821,0.919996857229844
"T","501020802",1998,"FEATHER R HATCHERY",27393,0,138,0,27531,0.994987468671679
"T","601140302",1991,"FEATHER R HATCHERY",52374,0,839,0,53213,0.984233176103584
"T","601061110",1999,"FEATHER R HATCHERY",19665,0,179,0,19844,0.990979641201371
"T","601140402",1993,"FEATHER R HATCHERY",51485,0,1925,0,53410,0.963958060288336
"T","601140310",1992,"FEATHER R HATCHERY",52857,0,2267,0,55124,0.958874537406574
"T","601061109",1999,"FEATHER R HATCHERY",19471,0,177,0,19648,0.990991449511401
"T","601140210",1991,"FEATHER R HATCHERY",51846,0,1341,0,53187,0.974787072028879
"T","601140407",1993,"FEATHER R HATCHERY",50235,0,2903,0,53138,0.945368662727239
"T","501020713",1998,"FEATHER R HATCHERY",26248,0,244,0,26492,0.990789672353918
"T","63136",1992,"FEATHER R HATCHERY",51560,0,2611,0,54171,0.951800779014602
"T","63130",1991,"FEATHER R HATCHERY",51914,0,1244,0,53158,0.976598066142443
"T","501020712",1998,"FEATHER R HATCHERY",26330,0,266,0,26596,0.989998496014438
"T","501020801",1998,"FEATHER R HATCHERY",22577,0,113,0,22690,0.995019832525342
"T","501020803",1999,"FEATHER R HATCHERY",24571,0,476,0,25047,0.980995728031301
"T","501020804",1999,"FEATHER R HATCHERY",25253,0,489,0,25742,0.981003807008002
"T","601060908",1998,"FEATHER R HATCHERY",50989,0,0,0,50989,1
"T","601060514",1997,"FEATHER R HATCHERY",38116,0,1179,0,39295,0.969996182720448
"T","601060907",1998,"FEATHER R HATCHERY",53987,0,0,0,53987,1
"T","601060909",1998,"FEATHER R HATCHERY",50804,0,307,0,51111,0.993993465203185
"T","65841",1982,"FEATHER R HATCHERY",39737,0,2313,0,42050,0.94499405469679
"T","H60401",1982,"FEATHER R HATCHERY",47367,0,2811,0,50178,0.943979433217745
"T","501020709",1998,"FEATHER R HATCHERY",25649,0,391,0,26040,0.984984639016897
"T","601061004",1999,"FEATHER R HATCHERY",24059,0,592,0,24651,0.975984747069084
"T","501020711",1998,"FEATHER R HATCHERY",24721,0,376,0,25097,0.985018129656931
"T","501020710",1998,"FEATHER R HATCHERY",27943,0,426,0,28369,0.984983608868836
"T","601060913",1999,"FEATHER R HATCHERY",25459,0,653,0,26112,0.974992340686274
"T","601060511",1997,"FEATHER R HATCHERY",21312,0,520,0,21832,0.976181751557347
"T","501020708",1998,"FEATHER R HATCHERY",25414,0,387,0,25801,0.985000581372815
"T","H60305",1982,"FEATHER R HATCHERY",45960,0,4270,0,50230,0.914991041210432
"T","601140205",1990,"FEATHER R HATCHERY",47289,0,7118,0,54407,0.869171246346977
"T","63127",1990,"FEATHER R HATCHERY",45706,0,6078,0,51784,0.882627838714661
"T","601060912",1999,"FEATHER R HATCHERY",27514,0,705,0,28219,0.975016832630497
"T","601060512",1997,"FEATHER R HATCHERY",22856,0,558,0,23414,0.976168104552832
"T","601061003",1999,"FEATHER R HATCHERY",26302,0,647,0,26949,0.975991688003265
"T","601140113",1989,"FEATHER R HATCHERY",52074,0,1932,0,54006,0.964226197089212
"T","601140306",1992,"FEATHER R HATCHERY",50016,0,3483,0,53499,0.9348959793641
"T","63148",1994,"FEATHER R HATCHERY",51422,0,1920,0,53342,0.964005849049529
"T","601060302",1996,"FEATHER R HATCHERY",23701,0,3083,0,26784,0.884893966547192
"T","601140504",1994,"FEATHER R HATCHERY",51702,0,1742,0,53444,0.967405134346232
"T","601140501",1994,"FEATHER R HATCHERY",50849,0,1037,0,51886,0.980013876575569
"T","63135",1992,"FEATHER R HATCHERY",51937,0,792,0,52729,0.984979802385784
"T","601140112",1989,"FEATHER R HATCHERY",51521,0,2813,0,54334,0.948227629108845
"T","63134",1991,"FEATHER R HATCHERY",52931,0,1105,0,54036,0.979550669923755
"T","601060303",1996,"FEATHER R HATCHERY",25073,0,3261,0,28334,0.884908590386109
"T","63138",1992,"FEATHER R HATCHERY",52616,0,1741,0,54357,0.967971006494104
"T","601060114",1995,"FEATHER R HATCHERY",49024,0,2596,0,51620,0.949709414955444
"T","601140404",1993,"FEATHER R HATCHERY",50726,0,4722,0,55448,0.914839128552878
"T","601060115",1995,"FEATHER R HATCHERY",51718,0,1062,0,52780,0.979878741947707
"T","63132",1991,"FEATHER R HATCHERY",48455,0,3709,0,52164,0.92889732382486
"T","601060205",1995,"FEATHER R HATCHERY",49194,0,2550,0,51744,0.95071892393321
"T","63150",1994,"FEATHER R HATCHERY",52297,0,422,0,52719,0.991995295813654
"T","601140105",1989,"FEATHER R HATCHERY",53313,0,1232,0,54545,0.977413145109543
"T","601140106",1989,"FEATHER R HATCHERY",52954,0,687,0,53641,0.987192632501258
"T","63151",1994,"FEATHER R HATCHERY",50265,0,2424,0,52689,0.953994192336161
"T","601140215",1991,"FEATHER R HATCHERY",49948,0,1882,0,51830,0.963688983214355
"T","63143",1993,"FEATHER R HATCHERY",53880,0,657,0,54537,0.987953132735574
"T","601140304",1991,"FEATHER R HATCHERY",51445,0,1183,0,52628,0.977521471460059
"T","63141",1993,"FEATHER R HATCHERY",51632,0,1489,0,53121,0.971969654185727
"T","63131",1991,"FEATHER R HATCHERY",51262,0,3101,0,54363,0.942957526258669
"T","601140214",1991,"FEATHER R HATCHERY",53754,0,1890,0,55644,0.966034073754583
"T","601140315",1993,"FEATHER R HATCHERY",51084,0,2581,0,53665,0.951905338675114
"T","601140212",1991,"FEATHER R HATCHERY",54073,0,17458,1267,72798,0.742781395093272
"T","601140213",1991,"FEATHER R HATCHERY",53030,0,1057,0,54087,0.980457411207869
"T","601060201",1995,"FEATHER R HATCHERY",50462,0,2108,0,52570,0.959901084268594
"T","601140414",1994,"FEATHER R HATCHERY",50120,0,1391,0,51511,0.972996059094174
"T","63133",1992,"FEATHER R HATCHERY",52454,0,1426,0,53880,0.973533778767632
"T","601140303",1991,"FEATHER R HATCHERY",53294,0,703,0,53997,0.98698075819027
"T","601140312",1992,"FEATHER R HATCHERY",55742,0,908,0,56650,0.983971756398941
"T","65862",1984,"FEATHER R HATCHERY",23874,0,34100,1204,59178,0.403426949204096
"T","65845",1982,"FEATHER R HATCHERY",45980,0,2016,0,47996,0.957996499708309
"T","65825",1980,"FEATHER R HATCHERY",43103,0,4473,0,47576,0.905982007734992
"T","65835",1981,"FEATHER R HATCHERY",24902,0,100,0,25002,0.996000319974402
"T","65857",1984,"FEATHER R HATCHERY",24349,0,1380,0,25729,0.946364025030122
"T","65838",1982,"FEATHER R HATCHERY",47480,0,1118,0,48598,0.976994938063295
"T","65817",1979,"FEATHER R HATCHERY",77700,0,15538,0,93238,0.833351208734636
"T","63125",1990,"FEATHER R HATCHERY",49393,0,2615,0,52008,0.949719273957853
"T","601140202",1990,"FEATHER R HATCHERY",48213,0,6271,0,54484,0.884901989574921
"T","63126",1990,"FEATHER R HATCHERY",50427,0,3816,0,54243,0.929649908743985
"T","601140201",1990,"FEATHER R HATCHERY",51128,0,2377,0,53505,0.955574245397626
"T","601060615",1997,"FEATHER R HATCHERY",40687,0,538,0,41225,0.986949666464524
"T","601060614",1997,"FEATHER R HATCHERY",42987,0,538,0,43525,0.987639287765652
"T","62635",1998,"FEATHER R HATCHERY",50883,0,1038,0,51921,0.980008089212457
"T","62531",1994,"FEATHER R HATCHERY",55498,0,845,0,56343,0.985002573522887
"T","601140415",1994,"FEATHER R HATCHERY",57593,0,1279,0,58872,0.978274901481179
"T","62631",1998,"FEATHER R HATCHERY",50877,0,1038,0,51915,0.980005778676683
"T","62530",1994,"FEATHER R HATCHERY",54906,0,836,0,55742,0.985002332173227
"T","601141104",1992,"FEATHER R HATCHERY",25899,0,530,0,26429,0.979946271141549
"T","601140203",1990,"FEATHER R HATCHERY",48255,0,7419,0,55674,0.86674210583037
"T","65839",1982,"FEATHER R HATCHERY",47280,0,2021,0,49301,0.959006916695402
"T","65859",1984,"FEATHER R HATCHERY",23251,0,1940,0,25191,0.922988368861895
"T","65831",1981,"FEATHER R HATCHERY",46410,0,2340,0,48750,0.952
"T","65843",1982,"FEATHER R HATCHERY",37500,0,1482,0,38982,0.961982453440049
"T","65842",1982,"FEATHER R HATCHERY",41756,0,2244,0,44000,0.949
"T","65821",1980,"FEATHER R HATCHERY",41917,0,4354,0,46271,0.905902184953859
"T","65829",1981,"FEATHER R HATCHERY",27781,0,3019,0,30800,0.901980519480519
"T","65826",1980,"FEATHER R HATCHERY",43800,0,4300,0,48100,0.910602910602911
"T","65832",1981,"FEATHER R HATCHERY",44933,0,2167,0,47100,0.953991507430998
"T","62636",1998,"FEATHER R HATCHERY",50932,0,1039,0,51971,0.980008081430028
"T","601140411",1994,"FEATHER R HATCHERY",34384,0,809,0,35193,0.977012474071548
"T","62634",1998,"FEATHER R HATCHERY",50928,0,1039,0,51967,0.980006542613582
"T","62633",1998,"FEATHER R HATCHERY",51964,0,1060,0,53024,0.980009052504526
"T","62637",1998,"FEATHER R HATCHERY",49140,0,1003,0,50143,0.979997207985162
"T","601140410",1994,"FEATHER R HATCHERY",56971,0,1341,0,58312,0.977003018246673
"T","62638",1998,"FEATHER R HATCHERY",50827,0,1037,0,51864,0.980005398735153
"T","62533",1994,"FEATHER R HATCHERY",32219,0,491,0,32710,0.984989299908285
"T","62532",1994,"FEATHER R HATCHERY",56162,0,856,0,57018,0.984987197025501
"T","601140409",1994,"FEATHER R HATCHERY",56647,0,1334,0,57981,0.97699246304824
"T","62632",1998,"FEATHER R HATCHERY",50893,0,1039,0,51932,0.979993067857968
"T","63137",1992,"FEATHER R HATCHERY",49699,0,2792,0,52491,0.946809929321217
"T","66263",1987,"FEATHER R HATCHERY",53961,0,436,0,54397,0.991984852105815
"T","601140102",1988,"FEATHER R HATCHERY",51134,0,1531,0,52665,0.970929459793031
"T","63103",1987,"FEATHER R HATCHERY",53942,0,217,0,54159,0.995993279048727
"T","66229",1983,"FEATHER R HATCHERY",44818,0,1197,0,46015,0.973986743453222
"T","63122",1989,"FEATHER R HATCHERY",50837,0,1861,0,52698,0.96468556681468
"T","63129",1991,"FEATHER R HATCHERY",53099,0,596,0,53695,0.988900270043766
"T","65837",1982,"FEATHER R HATCHERY",34600,0,1404,0,36004,0.961004332851905
"T","65830",1981,"FEATHER R HATCHERY",26291,0,1384,0,27675,0.949990966576332
"T","65823",1980,"FEATHER R HATCHERY",8864,0,586,0,9450,0.937989417989418
"T","601141103",1992,"FEATHER R HATCHERY",28056,0,574,0,28630,0.979951100244499
"T","66214",1980,"FEATHER R HATCHERY",71932,0,3468,0,75400,0.954005305039788
"T","601140204",1990,"FEATHER R HATCHERY",47347,0,7609,0,54956,0.861543780478929
"T","501020707",1998,"FEATHER R HATCHERY",25633,0,338,0,25971,0.986985483808864
"T","601060508",1997,"FEATHER R HATCHERY",21556,0,133,0,21689,0.993867859283508
"T","601060509",1997,"FEATHER R HATCHERY",17830,0,110,0,17940,0.99386845039019
"T","66221",1981,"FEATHER R HATCHERY",60822,0,8928,0,69750,0.872
"T","66202",1977,"FEATHER R HATCHERY",162253,0,20069,0,182322,0.889925516394072
"T","66208",1979,"FEATHER R HATCHERY",98586,0,3894,0,102480,0.962002341920375
"T","66205",1978,"FEATHER R HATCHERY",160151,0,32030,0,192181,0.833334200571336
"T","66217",1980,"FEATHER R HATCHERY",68318,0,11182,0,79500,0.859345911949686
"T","66211",1979,"FEATHER R HATCHERY",84643,0,5307,0,89950,0.941000555864369
"T","66220",1981,"FEATHER R HATCHERY",85885,0,13865,0,99750,0.861002506265664
"T","62929",1994,"FEATHER R HATCHERY",50596,0,1944,0,52540,0.962999619337648
"T","H60307",1982,"FEATHER R HATCHERY",48580,0,3322,0,51902,0.935994759354167
"T","66226",1982,"FEATHER R HATCHERY",89500,0,10500,0,1e+05,0.895
"T","H60306",1982,"FEATHER R HATCHERY",47677,0,3098,0,50775,0.938985721319547
"T","63140",1992,"FEATHER R HATCHERY",50116,0,2981,0,53097,0.943857468406878
"T","601060106",1994,"FEATHER R HATCHERY",51631,0,1215,0,52846,0.977008666691897
"T","601140604",1995,"FEATHER R HATCHERY",50371,0,1030,0,51401,0.979961479348651
"T","62527",1994,"FEATHER R HATCHERY",53398,0,923,0,54321,0.983008412952633
"T","62528",1994,"FEATHER R HATCHERY",53486,0,925,0,54411,0.982999761077723
"T","601060104",1994,"FEATHER R HATCHERY",54304,0,1278,0,55582,0.977006944694325
"T","601140602",1995,"FEATHER R HATCHERY",51610,0,1055,0,52665,0.979967720497484
"T","601060105",1994,"FEATHER R HATCHERY",52394,0,1233,0,53627,0.977007850523057
"T","601140601",1995,"FEATHER R HATCHERY",50890,0,1041,0,51931,0.979954169956288
"T","62526",1994,"FEATHER R HATCHERY",52249,0,904,0,53153,0.982992493368201
"T","62529",1994,"FEATHER R HATCHERY",42526,0,735,0,43261,0.983010101477081
"T","601060107",1994,"FEATHER R HATCHERY",38635,0,909,0,39544,0.97701294760267
"T","601140603",1995,"FEATHER R HATCHERY",51300,0,1049,0,52349,0.97996141282546
"T","63803",1992,"FEATHER R HATCHERY",27134,0,0,0,27134,1
"T","601060507",1997,"FEATHER R HATCHERY",21380,0,131,0,21511,0.993910092510808
"T","52417",1998,"FEATHER R HATCHERY",26174,0,399,0,26573,0.984984758965868
"T","62656",1999,"FEATHER R HATCHERY",25011,0,253,0,25264,0.989985750474984
"T","52325",1998,"FEATHER R HATCHERY",25977,0,131,0,26108,0.994982380879424
"T","52324",1998,"FEATHER R HATCHERY",25695,0,129,0,25824,0.995004646840149
"T","62654",1999,"FEATHER R HATCHERY",20613,0,208,0,20821,0.990010085970895
"T","601140503",1994,"FEATHER R HATCHERY",50292,0,1026,0,51318,0.980007015082427
"T","601060213",1996,"FEATHER R HATCHERY",25829,0,1048,0,26877,0.961007552926294
"T","601140208",1990,"FEATHER R HATCHERY",51272,0,1186,0,52458,0.977391436959091
"T","B61406",1987,"FEATHER R HATCHERY",51005,0,1585,0,52590,0.969861190340369
"T","63139",1992,"FEATHER R HATCHERY",49786,0,2031,0,51817,0.960804369222456
"T","601140207",1990,"FEATHER R HATCHERY",51392,0,2805,0,54197,0.948244367769434
"T","63110",1988,"FEATHER R HATCHERY",52612,0,532,0,53144,0.989989462592202
"T","601060209",1996,"FEATHER R HATCHERY",25152,0,1296,0,26448,0.950998185117967
"T","66261",1987,"FEATHER R HATCHERY",49245,0,4050,0,53295,0.924007880664227
"T","601060212",1996,"FEATHER R HATCHERY",25032,0,1097,0,26129,0.958015997550614
"T","B61407",1987,"FEATHER R HATCHERY",51753,0,1585,0,53338,0.970283850163111
"T","63117",1988,"FEATHER R HATCHERY",49909,0,1655,0,51564,0.967903964005896
"T","601060210",1996,"FEATHER R HATCHERY",25069,0,1291,0,26360,0.951024279210926
"T","601060214",1996,"FEATHER R HATCHERY",26315,0,1068,0,27383,0.960997699302487
"T","601060211",1996,"FEATHER R HATCHERY",25642,0,1123,0,26765,0.958042219316271
"T","601140311",1992,"FEATHER R HATCHERY",54454,0,1418,0,55872,0.974620561282932
"T","601140313",1992,"FEATHER R HATCHERY",51574,0,1712,0,53286,0.967871485943775
"T","601060411",1997,"FEATHER R HATCHERY",25708,0,1682,0,27390,0.938590726542534
"T","601060410",1997,"FEATHER R HATCHERY",25835,0,1690,0,27525,0.938601271571299
"T","601060413",1997,"FEATHER R HATCHERY",27027,0,669,0,27696,0.975844887348354
"T","601060412",1997,"FEATHER R HATCHERY",25701,0,636,0,26337,0.975851463720241
"T","63116",1988,"FEATHER R HATCHERY",49762,0,1914,0,51676,0.962961529530149
"T","63123",1989,"FEATHER R HATCHERY",49324,0,4536,0,53860,0.915781656145563
"T","63801",1992,"FEATHER R HATCHERY",99787,0,0,0,99787,1
"T","62936",1995,"FEATHER R HATCHERY",58815,0,2135,0,60950,0.964971287940935
"T","62926",1993,"FEATHER R HATCHERY",49166,0,4145,0,53311,0.922248691639624
"T","63106",1987,"FEATHER R HATCHERY",47975,0,4285,0,52260,0.918006123230004
"T","63105",1987,"FEATHER R HATCHERY",49342,0,4408,0,53750,0.917990697674419
"T","601140101",1988,"FEATHER R HATCHERY",51237,0,336,0,51573,0.993484963062067
"T","63121",1989,"FEATHER R HATCHERY",52010,0,1087,0,53097,0.979528033598885
"T","62538",1995,"FEATHER R HATCHERY",53172,0,0,0,53172,1
"T","601060510",1997,"FEATHER R HATCHERY",16498,0,102,0,16600,0.993855421686747
"T","52416",1998,"FEATHER R HATCHERY",25621,0,390,0,26011,0.98500634347007
"T","501020706",1998,"FEATHER R HATCHERY",25585,0,337,0,25922,0.986999459918216
"T","601060803",1998,"FEATHER R HATCHERY",26317,0,0,0,26317,1
"T","62653",1999,"FEATHER R HATCHERY",20926,0,211,0,21137,0.990017504849316
"T","62649",1999,"FEATHER R HATCHERY",17416,0,319,0,17735,0.982012968705949
"T","62622",1997,"FEATHER R HATCHERY",47752,0,100660,3984,152396,0.313341557521195
"T","63758",1992,"FEATHER R HATCHERY",2628,0,0,0,2628,1
"T","62621",1997,"FEATHER R HATCHERY",46221,0,100660,3856,150737,0.306633407856067
"T","63819",1994,"FEATHER R HATCHERY",59530,0,0,0,59530,1
"T","63823",1996,"FEATHER R HATCHERY",48133,0,4529,0,52662,0.913998708746345
"T","63759",1994,"FEATHER R HATCHERY",1449,0,0,0,1449,1
"T","63827",1996,"FEATHER R HATCHERY",40658,0,3826,0,44484,0.913991547522705
"T","63822",1994,"FEATHER R HATCHERY",37112,0,0,0,37112,1
"T","63829",1996,"FEATHER R HATCHERY",42687,0,4017,0,46704,0.913990236382323
"T","62619",1997,"FEATHER R HATCHERY",47095,0,100660,3929,151684,0.310480999973629
"T","63802",1992,"FEATHER R HATCHERY",13543,0,0,0,13543,1
"T","63818",1993,"FEATHER R HATCHERY",43901,0,0,0,43901,1
"T","63650",1994,"FEATHER R HATCHERY",11018,0,0,0,11018,1
"T","63718",1994,"FEATHER R HATCHERY",5715,0,0,0,5715,1
"T","62552",1995,"FEATHER R HATCHERY",54092,0,0,0,54092,1
"T","62551",1997,"FEATHER R HATCHERY",46710,0,3897,0,50607,0.922994842610706
"T","601060515",1997,"FEATHER R HATCHERY",12730,0,1062,0,13792,0.922998839907193
"T","501020714",1998,"FEATHER R HATCHERY",25873,0,130,0,26003,0.995000576856517
"T","63101",1987,"FEATHER R HATCHERY",52741,0,1583,0,54324,0.970860025034975
"T","601140211",1991,"FEATHER R HATCHERY",53630,0,696,0,54326,0.987188454883481
"T","64209",1983,"FEATHER R HATCHERY",15180,0,405,0,15585,0.974013474494706
"T","52415",1998,"FEATHER R HATCHERY",25814,0,130,0,25944,0.994989207523898
"T","63120",1989,"FEATHER R HATCHERY",51878,0,1090,0,52968,0.979421537532095
"T","63112",1988,"FEATHER R HATCHERY",51046,0,831,0,51877,0.983981340478439
"T","66235",1984,"FEATHER R HATCHERY",107161,0,985,0,108146,0.990891942374198
"T","63107",1988,"FEATHER R HATCHERY",50601,0,2500,0,53101,0.952919907346378
"T","63102",1987,"FEATHER R HATCHERY",53238,0,431,0,53669,0.991969293260542
"T","501020805",1999,"FEATHER R HATCHERY",23042,0,303,0,23345,0.987020775326622
"T","601060202",1995,"FEATHER R HATCHERY",49881,0,1709,0,51590,0.96687342508238
"T","63145",1993,"FEATHER R HATCHERY",49976,0,1186,0,51162,0.976818732653141
"T","65860",1984,"FEATHER R HATCHERY",23307,0,2335,0,25642,0.908938460338507
"T","62544",1996,"FEATHER R HATCHERY",48562,0,3077,0,51639,0.940413253548674
"T","601140515",1995,"FEATHER R HATCHERY",50650,0,1024,0,51674,0.980183457831792
"T","62541",1996,"FEATHER R HATCHERY",52669,0,911,0,53580,0.982997387084733
"T","601140605",1995,"FEATHER R HATCHERY",53526,0,1095,0,54621,0.979952765419893
"T","62543",1996,"FEATHER R HATCHERY",50756,0,3217,0,53973,0.94039612398792
"T","62542",1996,"FEATHER R HATCHERY",52597,0,909,0,53506,0.983011251074646
"T","62615",1997,"FEATHER R HATCHERY",102545,0,3618,0,106163,0.965920330058495
"T","62535",1995,"FEATHER R HATCHERY",35111,0,0,0,35111,1
"T","60707",2015,"FEATHER R HATCHERY",145919,0,163,439143,585225,0.249338288692383
"T","60735",2015,"FEATHER R HATCHERY",244738,0,363,738423,983524,0.248837852457083
"T","60736",2015,"FEATHER R HATCHERY",246501,0,1107,744675,992283,0.248418042030348
"T","60738",2015,"FEATHER R HATCHERY",134250,762,405688,0,540700,0.248289254669872
"T","60739",2015,"FEATHER R HATCHERY",136655,0,459,412386,549500,0.248689717925387
"T","63826",1996,"FEATHER R HATCHERY",41550,0,3909,0,45459,0.914010426978156
"T","63825",1996,"FEATHER R HATCHERY",40640,0,3824,0,44464,0.913997840949982
"T","63821",1994,"FEATHER R HATCHERY",36155,0,0,0,36155,1
"T","63824",1996,"FEATHER R HATCHERY",47837,0,4501,0,52338,0.914001299247201
"T","63828",1996,"FEATHER R HATCHERY",41819,0,3935,0,45754,0.913996590462036
"T","63804",1992,"FEATHER R HATCHERY",19923,0,0,0,19923,1
"T","62618",1997,"FEATHER R HATCHERY",45795,0,100660,3820,150275,0.304741307602728
"T","63816",1993,"FEATHER R HATCHERY",49933,0,0,0,49933,1
"T","62620",1997,"FEATHER R HATCHERY",46011,0,100660,3838,150509,0.305702649011023
"T","601061008",1999,"FEATHER R HATCHERY",27302,0,416,0,27718,0.984991702143012
"T","601061007",1999,"FEATHER R HATCHERY",27250,0,415,0,27665,0.984999096331104
"T","60740",2015,"FEATHER R HATCHERY",133098,438,292,407802,541630,0.245736019053597
"T","60741",2015,"FEATHER R HATCHERY",137317,0,460,413117,550894,0.249262108500002
"T","60742",2015,"FEATHER R HATCHERY",134677,0,1070,406983,542730,0.248147329242902
"T","60743",2015,"FEATHER R HATCHERY",133609,0,747,401210,535566,0.249472520660385
"T","60745",2015,"FEATHER R HATCHERY",131292,0,298,393925,525515,0.249834923836617
"T","60746",2015,"FEATHER R HATCHERY",137383,0,412863,0,550246,0.249675599640888
"T","60747",2015,"FEATHER R HATCHERY",136890,0,412410,0,549300,0.249208083014746
"T","60744",2015,"FEATHER R HATCHERY",133168,0,306,398950,532424,0.250116448544769
"T","65861",1984,"FEATHER R HATCHERY",24609,0,1187,0,25796,0.953985113971158
"T","66244",1984,"FEATHER R HATCHERY",47518,0,5332,0,52850,0.899110690633869
"T","66252",1985,"FEATHER R HATCHERY",49583,0,3618,0,53201,0.931993759515799
"T","60793",2015,"FEATHER R HATCHERY",31510,0,95546,0,127056,0.24800088150107
"T","63115",1988,"FEATHER R HATCHERY",44695,0,5874,0,50569,0.883841879412288
"T","63118",1989,"FEATHER R HATCHERY",48390,0,6008,0,54398,0.889554763042759
"T","63124",1990,"FEATHER R HATCHERY",51086,0,2927,0,54013,0.945809342195397
"T","63142",1993,"FEATHER R HATCHERY",53232,0,1479,0,54711,0.972967045018369
"T","66262",1987,"FEATHER R HATCHERY",48647,0,4001,0,52648,0.924004710530315
"T","601060706",1998,"FEATHER R HATCHERY",25845,0,156,0,26001,0.994000230760355
"T","601060705",1998,"FEATHER R HATCHERY",26316,0,159,0,26475,0.99399433427762
"T","601060707",1998,"FEATHER R HATCHERY",26029,0,157,0,26186,0.99400442984801
"T","601061107",1999,"FEATHER R HATCHERY",52886,0,0,0,52886,1
"T","601060708",1998,"FEATHER R HATCHERY",25692,0,155,0,25847,0.994003172515186
"T","601060103",1995,"FEATHER R HATCHERY",100033,0,4198,0,104231,0.959724074411643
"T","62930",1994,"FEATHER R HATCHERY",46290,0,2181,0,48471,0.955004023024076
"T","62935",1995,"FEATHER R HATCHERY",56900,0,1669,0,58569,0.971503696494733
"T","601140513",1995,"FEATHER R HATCHERY",51755,0,1058,0,52813,0.979967053566357
"T","601140514",1995,"FEATHER R HATCHERY",57443,0,1175,0,58618,0.979954962639462
"T","601060108",1995,"FEATHER R HATCHERY",49708,0,2090,0,51798,0.9596509517742
"T","601140209",1990,"FEATHER R HATCHERY",53430,0,524,0,53954,0.990288023130815
"T","601140301",1991,"FEATHER R HATCHERY",53034,0,551,0,53585,0.989717271624522
"T","66248",1985,"FEATHER R HATCHERY",101320,0,5558,0,106878,0.947996781376897
"T","66258",1986,"FEATHER R HATCHERY",51008,0,2180,0,53188,0.95901331127322
"T","52414",1998,"FEATHER R HATCHERY",26489,0,133,0,26622,0.995004131920968
"T","601140401",1993,"FEATHER R HATCHERY",51819,0,1882,0,53701,0.964954097689056
"T","601140309",1992,"FEATHER R HATCHERY",53265,0,1791,0,55056,0.967469485614647
"T","601140405",1993,"FEATHER R HATCHERY",50259,0,2260,0,52519,0.956967954454578
"T","601140314",1993,"FEATHER R HATCHERY",50032,0,2471,0,52503,0.952936022703465
"T","66242",1984,"FEATHER R HATCHERY",105289,0,2360,0,107649,0.978076898066865
"T","63113",1988,"FEATHER R HATCHERY",51972,0,526,0,52498,0.989980570688407
"T","66233",1983,"FEATHER R HATCHERY",64896,0,2704,0,67600,0.96
"T","601140308",1992,"FEATHER R HATCHERY",52747,0,2612,0,55359,0.952817066782276
"T","62932",1994,"FEATHER R HATCHERY",147816,0,4729,0,152545,0.968999311678521
"T","601140508",1995,"FEATHER R HATCHERY",47188,0,1309,0,48497,0.973008639709673
"T","601140511",1995,"FEATHER R HATCHERY",50150,0,1392,0,51542,0.972992898994994
"T","62938",1995,"FEATHER R HATCHERY",149440,0,6232,0,155672,0.95996711033455
"T","62933",1994,"FEATHER R HATCHERY",139443,0,13559,0,153002,0.911380243395511
"T","601140507",1995,"FEATHER R HATCHERY",47446,0,1316,0,48762,0.973011771461384
"T","601140509",1995,"FEATHER R HATCHERY",49142,0,1364,0,50506,0.972993307725815
"T","601140512",1995,"FEATHER R HATCHERY",49682,0,1379,0,51061,0.972993086700221
"T","62937",1995,"FEATHER R HATCHERY",150089,0,4802,0,154891,0.968997553117999
"T","601140510",1995,"FEATHER R HATCHERY",49410,0,1371,0,50781,0.973001713239204
"T","66247",1985,"FEATHER R HATCHERY",101949,0,3807,0,105756,0.964002042437308
"T","66236",1984,"FEATHER R HATCHERY",101236,0,5634,0,106870,0.947281744175166
"T","66232",1983,"FEATHER R HATCHERY",59808,0,2492,0,62300,0.96
"T","62660",1999,"FEATHER R HATCHERY",42275,0,775,0,43050,0.981997677119628
"T","601060814",1998,"FEATHER R HATCHERY",51144,0,1258,0,52402,0.975993282699134
"T","601060815",1998,"FEATHER R HATCHERY",51043,0,1255,0,52298,0.976002906420896
"T","601140502",1994,"FEATHER R HATCHERY",51597,0,1269,0,52866,0.975995914198161
"T","501020715",1998,"FEATHER R HATCHERY",25133,0,126,0,25259,0.995011679005503
"T","601140406",1993,"FEATHER R HATCHERY",56139,0,2402,0,58541,0.958968927760031
"T","66255",1986,"FEATHER R HATCHERY",51103,0,2464,0,53567,0.954001530793212
"T","501020808",1999,"FEATHER R HATCHERY",21395,0,282,0,21677,0.986990819762882
"T","501020806",1999,"FEATHER R HATCHERY",23468,0,309,0,23777,0.987004247802498
"T","66249",1985,"FEATHER R HATCHERY",98869,0,5533,0,104402,0.947002930978334
"T","601080602",2018,"FEATHER R HATCHERY",30000,0,0,0,30000,1
"T","601060206",1995,"FEATHER R HATCHERY",50168,0,1562,0,51730,0.969804755461048
"T","601060305",1996,"FEATHER R HATCHERY",24746,0,1949,0,26695,0.926990073047387
"T","601060203",1995,"FEATHER R HATCHERY",49868,0,2083,0,51951,0.959904525418182
"T","63149",1994,"FEATHER R HATCHERY",51670,0,1265,0,52935,0.976102767545103
"T","601140107",1989,"FEATHER R HATCHERY",52488,0,879,0,53367,0.983529147225814
"T","601140114",1990,"FEATHER R HATCHERY",52097,0,3311,0,55408,0.940243286168062
"T","601140606",1997,"FEATHER R HATCHERY",23927,0,450,0,24377,0.98153997620708
"T","64822",1983,"FEATHER R HATCHERY",47500,0,2565,0,50065,0.94876660341556
"T","601060608",1997,"FEATHER R HATCHERY",19139,0,578060,429,597628,0.0320249385905614
"T","060201*1",1972,"FEATHER R HATCHERY",197706,0,26960,0,224666,0.879999643915857
"T","60106",1974,"FEATHER R HATCHERY",92871,0,8076,0,100947,0.919997622514785
"T","60104",1973,"FEATHER R HATCHERY",156606,0,23401,0,180007,0.869999500019444
"T","62658",1999,"FEATHER R HATCHERY",294362,0,7238,0,301600,0.976001326259947
"T","601060702",1998,"FEATHER R HATCHERY",27699,0,827,0,28526,0.971008904157611
"T","601060704",1998,"FEATHER R HATCHERY",25269,0,755,0,26024,0.970988318475254
"T","601060701",1998,"FEATHER R HATCHERY",25241,0,754,0,25995,0.970994422004232
"T","601060703",1998,"FEATHER R HATCHERY",25262,0,754,0,26016,0.971017835178352
"T","601060112",1995,"FEATHER R HATCHERY",49923,0,2087,0,52010,0.959873101326668
"T","601060111",1995,"FEATHER R HATCHERY",48100,0,3000,0,51100,0.941291585127202
"T","601140505",1995,"FEATHER R HATCHERY",50103,0,1557,0,51660,0.9698606271777
"T","60306",1975,"FEATHER R HATCHERY",93642,0,4929,0,98571,0.94999543476276
"T","65801",1986,"FEATHER R HATCHERY",48570,0,2077,0,50647,0.958990660848619
"T","601060501",1997,"FEATHER R HATCHERY",15275,0,156,0,15431,0.98989048020219
"T","601060607",1997,"FEATHER R HATCHERY",17989,0,578060,403,596452,0.0301600128761409
"T","63146",1993,"FEATHER R HATCHERY",51804,0,1608,0,53412,0.969894405751517
"T","601140506",1995,"FEATHER R HATCHERY",51288,0,512,0,51800,0.99011583011583
"T","63805",1993,"FEATHER R HATCHERY",98795,0,4010,0,102805,0.960994115072224
"T","601060613",1997,"FEATHER R HATCHERY",17777,0,578060,399,596236,0.029815375119919
"T","601060612",1997,"FEATHER R HATCHERY",18123,0,578060,407,596590,0.0303776462897467
"T","601140307",1992,"FEATHER R HATCHERY",49335,0,4245,0,53580,0.920772676371781
"T","65849",1985,"FEATHER R HATCHERY",50055,0,2195,0,52250,0.95799043062201
"T","65802",1986,"FEATHER R HATCHERY",44187,0,5798,0,49985,0.884005201560468
"T","63806",1993,"FEATHER R HATCHERY",99394,0,3286,0,102680,0.967997662641215
"T","601060610",1997,"FEATHER R HATCHERY",17836,0,578060,400,596296,0.0299113192105934
"T","62331",1994,"FEATHER R HATCHERY",62597,0,2421,0,65018,0.96276415761789
"T","62519",1993,"FEATHER R HATCHERY",103078,0,5672,0,108750,0.94784367816092
"T","65848",1985,"FEATHER R HATCHERY",46077,0,6643,0,52720,0.87399468892261
"T","62909",1993,"FEATHER R HATCHERY",9034,0,721,0,9755,0.926089185033316
"T","62931",1994,"FEATHER R HATCHERY",62597,0,2421,0,65018,0.96276415761789
"T","62921",1993,"FEATHER R HATCHERY",22078,0,1762,0,23840,0.926090604026846
"T","62920",1993,"FEATHER R HATCHERY",21399,0,1708,0,23107,0.926083005149955
"T","62934",1995,"FEATHER R HATCHERY",68630,0,2178,0,70808,0.969240763755508
"T","62910",1993,"FEATHER R HATCHERY",8834,0,705,0,9539,0.926092881853444
"T","66234",1984,"FEATHER R HATCHERY",100386,0,4401,0,104787,0.9580005153311
"T","64208",1983,"FEATHER R HATCHERY",14916,0,785,0,15701,0.950003184510541
"T","66228",1983,"FEATHER R HATCHERY",41371,0,2178,0,43549,0.949987370548118
"T","66246",1985,"FEATHER R HATCHERY",102965,0,3956,0,106921,0.963000720157874
"T","62517",1993,"FEATHER R HATCHERY",102991,0,1467,0,104458,0.985956078040935
"T","601140115",1990,"FEATHER R HATCHERY",50902,0,3179,0,54081,0.941217802925242
"T","601140607",1997,"FEATHER R HATCHERY",24330,0,457,0,24787,0.981562916044701
"T","601060204",1995,"FEATHER R HATCHERY",50243,0,1028,0,51271,0.979949679155858
"T","64823",1983,"FEATHER R HATCHERY",47500,0,2090,0,49590,0.957854406130268
"T","601140110",1989,"FEATHER R HATCHERY",52559,0,1491,0,54050,0.972414431082331
"T","63147",1994,"FEATHER R HATCHERY",52097,0,579,0,52676,0.9890082770142
"T","601060304",1996,"FEATHER R HATCHERY",25084,0,1975,0,27059,0.927011345578181
"T","601140412",1994,"FEATHER R HATCHERY",50848,0,1465,0,52313,0.971995488693059
"T","601140111",1989,"FEATHER R HATCHERY",50974,0,3771,0,54745,0.931116996986026
"T","601060110",1995,"FEATHER R HATCHERY",48770,0,2577,0,51347,0.949812063022182
"T","63144",1993,"FEATHER R HATCHERY",54297,0,773,0,55070,0.985963319411658
"T","63756",1993,"FEATHER R HATCHERY",50160,0,1661,0,51821,0.967947357248992
"T","65803",1986,"FEATHER R HATCHERY",45982,0,4053,0,50035,0.918996702308384
"T","601060609",1997,"FEATHER R HATCHERY",17525,0,578060,393,595978,0.0294054478521019
"T","601060611",1997,"FEATHER R HATCHERY",18027,0,578060,404,596491,0.0302217468494914
"T","66225",1982,"FEATHER R HATCHERY",83435,0,6765,0,90200,0.925
"T","62518",1993,"FEATHER R HATCHERY",101125,0,5455,0,106580,0.948817789453931
"T","601060502",1997,"FEATHER R HATCHERY",15283,0,156,0,15439,0.989895718634627
"T","601140305",1992,"FEATHER R HATCHERY",53066,0,2416,0,55482,0.956454345553513
"T","63757",1993,"FEATHER R HATCHERY",50207,0,2038,0,52245,0.960991482438511
"T","601140108",1989,"FEATHER R HATCHERY",53254,0,925,0,54179,0.98292696432197
"T","63114",1988,"FEATHER R HATCHERY",52962,0,160,0,53122,0.996988065208388
"T","601060313",1996,"FEATHER R HATCHERY",51042,0,516,0,51558,0.989991853834516
"T","601060315",1996,"FEATHER R HATCHERY",51824,0,523,0,52347,0.990008978547004
"T","601060312",1996,"FEATHER R HATCHERY",52408,0,530,0,52938,0.98998828818618
"T","601060314",1996,"FEATHER R HATCHERY",54728,0,553,0,55281,0.989996563014417
"T","608000702",2011,"FEATHER R HATCHERY",10218,0,0,0,10218,1
"T","601060505",1997,"FEATHER R HATCHERY",15537,0,259,0,15796,0.983603443909851
"T","68042",2013,"FEATHER R HATCHERY",25810,0,78357,0,104167,0.247775207119337
"T","60618",2013,"FEATHER R HATCHERY",366033,404,808,1213,368458,0.993418517171564
"T","68681",2013,"FEATHER R HATCHERY",137255,0,411965,0,549220,0.249908961800371
"T","601060415",1997,"FEATHER R HATCHERY",21180,0,306,0,21486,0.985758168109467
"T","601060506",1997,"FEATHER R HATCHERY",18365,0,305,0,18670,0.983663631494376
"T","601060414",1997,"FEATHER R HATCHERY",21405,0,309,0,21714,0.985769549599337
"T","68738",2014,"FEATHER R HATCHERY",2682,12,8082,0,10776,0.248886414253898
"T","60658",2014,"FEATHER R HATCHERY",263851,1179,790219,0,1055249,0.250036721190923
"T","608000805",2012,"FEATHER R HATCHERY",9104,0,0,0,9104,1
"T","608000801",2012,"FEATHER R HATCHERY",9448,0,0,0,9448,1
"T","608000806",2012,"FEATHER R HATCHERY",9974,0,0,0,9974,1
"T","608000802",2012,"FEATHER R HATCHERY",10123,0,0,0,10123,1
"T","601020808",2013,"FEATHER R HATCHERY",44127,0,0,0,44127,1
"T","601020903",2014,"FEATHER R HATCHERY",45200,0,0,0,45200,1
"T","60578",2014,"FEATHER R HATCHERY",10336,20,0,0,10356,0.998068752414059
"T","60656",2014,"FEATHER R HATCHERY",396174,1331,2218,1198887,1598610,0.247824047140954
"T","60657",2014,"FEATHER R HATCHERY",385145,1291,861,1139693,1526990,0.252224965454915
"T","60662",2014,"FEATHER R HATCHERY",321527,0,7863,1787,331177,0.970861503063317
"T","608000108",2012,"FEATHER R HATCHERY",39240,0,0,0,39240,1
"T","608000800",2012,"FEATHER R HATCHERY",10556,0,0,0,10556,1
"T","608000803",2012,"FEATHER R HATCHERY",11069,0,0,0,11069,1
"T","608000804",2012,"FEATHER R HATCHERY",10128,0,0,0,10128,1
"T","608000808",2012,"FEATHER R HATCHERY",6068,0,0,0,6068,1
"T","608000809",2012,"FEATHER R HATCHERY",6012,0,0,0,6012,1
"T","608000900",2012,"FEATHER R HATCHERY",7086,0,0,0,7086,1
"T","601010000",2003,"FEATHER R HATCHERY",9576,0,1005,0,10581,0.905018429259994
"T","601010006",2003,"FEATHER R HATCHERY",10144,0,648,0,10792,0.93995552260934
"T","601010102",2003,"FEATHER R HATCHERY",10449,0,596,0,11045,0.946038931643277
"T","601010108",2003,"FEATHER R HATCHERY",9775,0,547,0,10322,0.947006394109669
"T","601010001",2003,"FEATHER R HATCHERY",9480,0,995,0,10475,0.905011933174224
"T","62408",2003,"FEATHER R HATCHERY",116420,0,2376,0,118796,0.979999326576652
"T","60201",1972,"FEATHER R HATCHERY",197706,0,26960,0,224666,0.879999643915857
"T","601010002",2003,"FEATHER R HATCHERY",9693,0,1017,0,10710,0.905042016806723
"T","601010003",2003,"FEATHER R HATCHERY",9547,0,1002,0,10549,0.905014693335861
"T","601010005",2003,"FEATHER R HATCHERY",10190,0,650,0,10840,0.940036900369004
"T","601010008",2003,"FEATHER R HATCHERY",9776,0,624,0,10400,0.94
"T","601010009",2003,"FEATHER R HATCHERY",10126,0,646,0,10772,0.940029706646862
"T","601010100",2003,"FEATHER R HATCHERY",9877,0,564,0,10441,0.945982185614405
"T","601010101",2003,"FEATHER R HATCHERY",9629,0,550,0,10179,0.945967187346498
"T","601010103",2003,"FEATHER R HATCHERY",9570,0,546,0,10116,0.946026097271649
"T","601010104",2003,"FEATHER R HATCHERY",10700,0,611,0,11311,0.94598178764035
"T","601010105",2003,"FEATHER R HATCHERY",10195,0,571,0,10766,0.946962660226639
"T","601010106",2003,"FEATHER R HATCHERY",10058,0,563,0,10621,0.946991808680915
"T","601010107",2003,"FEATHER R HATCHERY",10337,0,579,0,10916,0.946958592891169
"T","601010109",2003,"FEATHER R HATCHERY",10373,0,581,0,10954,0.946960014606536
"T","62409",2003,"FEATHER R HATCHERY",116723,0,2382,0,119105,0.980000839595315
"T","62794",2003,"FEATHER R HATCHERY",113393,0,3507,0,116900,0.97
"T","601010007",2003,"FEATHER R HATCHERY",9977,0,637,0,10614,0.939984925570002
"T","601010004",2003,"FEATHER R HATCHERY",9638,0,1012,0,10650,0.904976525821596
"T","501040309",2003,"FEATHER R HATCHERY",25316,0,1332,0,26648,0.950015010507355
"T","501040401",2003,"FEATHER R HATCHERY",24758,0,1303,0,26061,0.950001918575649
"T","501040402",2003,"FEATHER R HATCHERY",22692,0,2108,0,24800,0.915
"T","501040403",2003,"FEATHER R HATCHERY",25017,0,2324,0,27341,0.914999451373395
"T","601010501",2005,"FEATHER R HATCHERY",9979,0,0,0,9979,1
"T","601010607",2005,"FEATHER R HATCHERY",10894,0,110,0,11004,0.990003635041803
"T","601010903",2005,"FEATHER R HATCHERY",27688,0,280,0,27968,0.989988558352403
"T","601010502",2005,"FEATHER R HATCHERY",10557,0,0,0,10557,1
"T","601010503",2005,"FEATHER R HATCHERY",10427,0,0,0,10427,1
"T","601010504",2005,"FEATHER R HATCHERY",9868,0,0,0,9868,1
"T","601010505",2005,"FEATHER R HATCHERY",10395,0,0,0,10395,1
"T","601010507",2005,"FEATHER R HATCHERY",11009,0,190,0,11199,0.983034199482097
"T","601010509",2005,"FEATHER R HATCHERY",10732,0,186,0,10918,0.982963912804543
"T","601010600",2005,"FEATHER R HATCHERY",10276,0,178,0,10454,0.982973024679549
"T","601010603",2005,"FEATHER R HATCHERY",9509,0,96,0,9605,0.990005205622072
"T","601010604",2005,"FEATHER R HATCHERY",10396,0,105,0,10501,0.990000952290258
"T","62412",2004,"FEATHER R HATCHERY",118183,0,1194,0,119377,0.989998073330709
"T","62413",2004,"FEATHER R HATCHERY",118760,0,1200,0,119960,0.989996665555185
"T","62417",2004,"FEATHER R HATCHERY",114824,0,1749,0,116573,0.984996525782128
"T","601010508",2005,"FEATHER R HATCHERY",10872,0,188,0,11060,0.983001808318264
"T","601010601",2005,"FEATHER R HATCHERY",11036,0,111,0,11147,0.990042163810891
"T","601010608",2005,"FEATHER R HATCHERY",10022,0,101,0,10123,0.99002272053739
"T","601010506",2005,"FEATHER R HATCHERY",10234,0,177,0,10411,0.982998751320718
"T","601010602",2005,"FEATHER R HATCHERY",11196,0,113,0,11309,0.99000795826333
"T","601010605",2005,"FEATHER R HATCHERY",11737,0,119,0,11856,0.989962887989204
"T","601010606",2005,"FEATHER R HATCHERY",10577,0,107,0,10684,0.989985024335455
"T","601010609",2005,"FEATHER R HATCHERY",10901,0,110,0,11011,0.99000999000999
"T","601010700",2005,"FEATHER R HATCHERY",10623,0,107,0,10730,0.990027958993476
"T","601010902",2005,"FEATHER R HATCHERY",28083,0,284,0,28367,0.989988366764198
"T","601010904",2005,"FEATHER R HATCHERY",27959,0,282,0,28241,0.990014517899508
"T","52067",2003,"FEATHER R HATCHERY",24829,0,507,0,25336,0.979988948531733
"T","62416",2004,"FEATHER R HATCHERY",116046,0,1173,0,117219,0.989993089857446
"T","62436",2004,"FEATHER R HATCHERY",25578,0,0,0,25578,1
"T","601010306",2004,"FEATHER R HATCHERY",52619,0,586,0,53205,0.988985997556621
"T","62796",2004,"FEATHER R HATCHERY",55116,0,840,0,55956,0.984988205018229
"T","62428",2004,"FEATHER R HATCHERY",25118,0,254,0,25372,0.989988964212518
"T","62415",2004,"FEATHER R HATCHERY",117688,0,1189,0,118877,0.989998065227083
"T","62432",2004,"FEATHER R HATCHERY",25833,0,261,0,26094,0.989997700620832
"T","601010305",2004,"FEATHER R HATCHERY",54365,0,1223,0,55588,0.977998848672375
"T","601010406",2004,"FEATHER R HATCHERY",26867,0,410,0,27277,0.984969021519962
"T","601010308",2004,"FEATHER R HATCHERY",51106,0,1854,0,52960,0.964992447129909
"T","67002",2006,"FEATHER R HATCHERY",305590,2377,927183,0,1235150,0.247411245597701
"T","67003",2006,"FEATHER R HATCHERY",305909,2132,927312,1063,1236416,0.247415918266991
"T","67004",2006,"FEATHER R HATCHERY",290950,13635,922731,2726,1230042,0.236536638586325
"T","67005",2006,"FEATHER R HATCHERY",283870,10971,905548,6879,1207268,0.23513420383875
"T","67006",2006,"FEATHER R HATCHERY",302437,1417,898999,1061,1203914,0.251211465270775
"T","62414",2004,"FEATHER R HATCHERY",113073,0,1143,0,114216,0.989992645513763
"T","601010307",2004,"FEATHER R HATCHERY",54324,0,1109,0,55433,0.979993866469432
"T","601090100",2006,"FEATHER R HATCHERY",10054,0,102,0,10156,0.989956675856636
"T","601080905",2006,"FEATHER R HATCHERY",25559,0,258,0,25817,0.990006584808459
"T","601080906",2006,"FEATHER R HATCHERY",26301,0,132,0,26433,0.995006242197253
"T","601080907",2006,"FEATHER R HATCHERY",25875,0,130,0,26005,0.995000961353586
"T","601090102",2006,"FEATHER R HATCHERY",10855,0,110,0,10965,0.989968080255358
"T","601090208",2006,"FEATHER R HATCHERY",11192,0,113,0,11305,0.99000442282176
"T","62324",2006,"FEATHER R HATCHERY",12252,0,0,0,12252,1
"T","67007",2006,"FEATHER R HATCHERY",173209,508,521675,508,695900,0.248899267136083
"T","67017",2006,"FEATHER R HATCHERY",138084,3228,427120,968,569400,0.242507903055848
"T","67018",2006,"FEATHER R HATCHERY",49259,1109,164254,378,215000,0.229111627906977
"T","67019",2006,"FEATHER R HATCHERY",52403,973,161150,474,215000,0.24373488372093
"T","67020",2006,"FEATHER R HATCHERY",39322,772,121351,356,161801,0.243026928140123
"T","62429",2004,"FEATHER R HATCHERY",25757,0,261,0,26018,0.989968483357676
"T","62430",2004,"FEATHER R HATCHERY",25245,0,255,0,25500,0.99
"T","62433",2004,"FEATHER R HATCHERY",25929,0,262,0,26191,0.989996563705089
"T","62434",2004,"FEATHER R HATCHERY",25586,0,523,0,26109,0.979968593205408
"T","62435",2004,"FEATHER R HATCHERY",26799,0,547,0,27346,0.979997074526439
"T","601090104",2006,"FEATHER R HATCHERY",11053,0,112,0,11165,0.989968652037618
"T","601090105",2006,"FEATHER R HATCHERY",10256,0,156,0,10412,0.98501728774491
"T","601090106",2006,"FEATHER R HATCHERY",10570,0,161,0,10731,0.984996738421396
"T","601090107",2006,"FEATHER R HATCHERY",10946,0,167,0,11113,0.984972554665707
"T","601090108",2006,"FEATHER R HATCHERY",10412,0,52,0,10464,0.995030581039755
"T","601090109",2006,"FEATHER R HATCHERY",11246,0,57,0,11303,0.994957091037778
"T","601090200",2006,"FEATHER R HATCHERY",10247,0,156,0,10403,0.985004325675286
"T","601090201",2006,"FEATHER R HATCHERY",9499,0,145,0,9644,0.984964744919121
"T","601090202",2006,"FEATHER R HATCHERY",9649,0,48,0,9697,0.995050015468702
"T","601090203",2006,"FEATHER R HATCHERY",10746,0,54,0,10800,0.995
"T","601090204",2006,"FEATHER R HATCHERY",9657,0,49,0,9706,0.994951576344529
"T","601090205",2006,"FEATHER R HATCHERY",11160,0,113,0,11273,0.989976048966557
"T","601090206",2006,"FEATHER R HATCHERY",11635,0,118,0,11753,0.989960010210159
"T","601090207",2006,"FEATHER R HATCHERY",10822,0,109,0,10931,0.990028359710914
"T","601090209",2006,"FEATHER R HATCHERY",10780,0,109,0,10889,0.989989898062265
"T","62795",2004,"FEATHER R HATCHERY",58571,0,892,0,59463,0.984999075055076
"T","62797",2004,"FEATHER R HATCHERY",59888,0,605,0,60493,0.98999884284132
"T","62798",2004,"FEATHER R HATCHERY",52725,0,533,0,53258,0.989992113860828
"T","601010401",2004,"FEATHER R HATCHERY",25591,0,390,0,25981,0.984989030445325
"T","601010402",2004,"FEATHER R HATCHERY",25591,0,390,0,25981,0.984989030445325
"T","601090101",2006,"FEATHER R HATCHERY",9867,0,100,0,9967,0.98996689073944
"T","601090103",2006,"FEATHER R HATCHERY",10458,0,106,0,10564,0.989965921999243
"T","67000",2006,"FEATHER R HATCHERY",284688,3384,874275,3499,1165846,0.244190055976518
"N","!08FRFH06-03",2005,"FEATHER R HATCHERY",0,0,59000,0,59000,0
"N","!08FRFH06-05",2005,"FEATHER R HATCHERY",0,0,57000,0,57000,0
"N","!08FRFH03-05",2002,"FEATHER R HATCHERY",0,0,133400,0,133400,0
"N","!08FRFH04-08",2003,"FEATHER R HATCHERY",0,0,3232600,0,3232600,0
"N","!08FRFH05-03",2004,"FEATHER R HATCHERY",0,0,135700,0,135700,0
"N","!08FRFH05-08",2004,"FEATHER R HATCHERY",0,0,3316976,0,3316976,0
"N","!08FRFH03-03",2002,"FEATHER R HATCHERY",0,0,1320700,0,1320700,0
"N","!08FRFH04-09",2003,"FEATHER R HATCHERY",0,0,192000,0,192000,0
"T","608000001",2007,"FEATHER R HATCHERY",54844,0,1120,0,55964,0.97998713458652
"T","60358",2007,"FEATHER R HATCHERY",27043,0,136,0,27179,0.994996136723205
"N","!08FRFH06-04",2005,"FEATHER R HATCHERY",0,0,3871900,0,3871900,0
"T","608000000",2007,"FEATHER R HATCHERY",52855,0,266,0,53121,0.994992564146006
"T","608000002",2007,"FEATHER R HATCHERY",53524,0,1373,0,54897,0.974989525839299
"N","!08FRFH03-02",2002,"FEATHER R HATCHERY",0,0,1022900,0,1022900,0
"N","!08FRFH03-04",2002,"FEATHER R HATCHERY",0,0,1694800,0,1694800,0
"N","!08FRFH03-07",2002,"FEATHER R HATCHERY",0,0,814200,0,814200,0
"N","!08FRFH03-08",2002,"FEATHER R HATCHERY",0,0,14689,0,14689,0
"N","!08FRFH04-05",2003,"FEATHER R HATCHERY",0,0,20000,0,20000,0
"N","!08FRFH04-06",2003,"FEATHER R HATCHERY",0,0,1223600,0,1223600,0
"N","!08FRFH04-07",2003,"FEATHER R HATCHERY",0,0,2802388,0,2802388,0
"N","!08FRFH05-02",2004,"FEATHER R HATCHERY",0,0,313500,0,313500,0
"N","!08FRFH05-04",2004,"FEATHER R HATCHERY",0,0,147900,0,147900,0
"N","!08FRFH05-05",2004,"FEATHER R HATCHERY",0,0,768200,0,768200,0
"N","!08FRFH05-06",2004,"FEATHER R HATCHERY",0,0,105000,0,105000,0
"N","!08FRFH05-07",2004,"FEATHER R HATCHERY",0,0,2596200,0,2596200,0
"N","!08FRFH06-01",2005,"FEATHER R HATCHERY",0,0,1909000,0,1909000,0
"N","!08FRFH06-02",2005,"FEATHER R HATCHERY",0,0,2852414,0,2852414,0
"T","67016",2007,"FEATHER R HATCHERY",281543,0,848081,0,1129624,0.249236028979554
"T","67026",2007,"FEATHER R HATCHERY",10168,0,30557,0,40725,0.249674647022713
"T","68604",2007,"FEATHER R HATCHERY",399244,0,1198460,0,1597704,0.249886086534177
"T","68605",2007,"FEATHER R HATCHERY",392455,0,5335,1194021,1591811,0.246546229420453
"T","68608",2007,"FEATHER R HATCHERY",261950,0,788042,0,1049992,0.249478091261648
"T","68609",2007,"FEATHER R HATCHERY",261343,0,784308,0,1045651,0.249933295143408
"T","68610",2007,"FEATHER R HATCHERY",267487,0,803352,0,1070839,0.249791985536575
"T","68611",2007,"FEATHER R HATCHERY",260203,0,781466,0,1041669,0.249794320460722
"T","68612",2007,"FEATHER R HATCHERY",213003,0,502,641001,854506,0.249270338651806
"T","60361",2007,"FEATHER R HATCHERY",25206,0,127,0,25333,0.994986776141791
"T","608000003",2007,"FEATHER R HATCHERY",55537,0,280,0,55817,0.994983607144777
"N","!08FRFH03-01",2002,"FEATHER R HATCHERY",0,0,904000,0,904000,0
"N","!08FRFH03-06",2002,"FEATHER R HATCHERY",0,0,607200,0,607200,0
"T","68606",2008,"FEATHER R HATCHERY",393802,0,1417,1192256,1587475,0.248068158553678
"T","68621",2008,"FEATHER R HATCHERY",44507,0,460,135037,180004,0.247255616541855
"T","68631",2008,"FEATHER R HATCHERY",76849,170,1104,0,78123,0.983692382524993
"T","68634",2008,"FEATHER R HATCHERY",397825,0,4486,1210387,1612698,0.24668288793066
"T","68635",2008,"FEATHER R HATCHERY",397598,0,5282,1210589,1613469,0.246424319277284
"T","68636",2008,"FEATHER R HATCHERY",398538,0,4117,1210837,1613492,0.247003393881098
"T","68650",2008,"FEATHER R HATCHERY",144831,0,1496,439667,585994,0.247154407724311
"T","68652",2008,"FEATHER R HATCHERY",92950,0,100,280191,373241,0.249034805929681
"T","67030",2009,"FEATHER R HATCHERY",5772,33,14,17503,23322,0.247491638795987
"T","67031",2009,"FEATHER R HATCHERY",5771,33,14,17503,23321,0.247459371382016
"T","68624",2009,"FEATHER R HATCHERY",41238,212,211,212,41873,0.984835096601629
"T","68654",2009,"FEATHER R HATCHERY",108744,3809,254,340735,453542,0.239766107659269
"T","68660",2009,"FEATHER R HATCHERY",53306,302,129,161647,215384,0.247492849979571
"T","68667",2009,"FEATHER R HATCHERY",261595,0,787219,0,1048814,0.249419820864329
"T","68668",2009,"FEATHER R HATCHERY",258683,654,991,782932,1043260,0.247956405881564
"T","68669",2009,"FEATHER R HATCHERY",393251,495,495,1190612,1584853,0.248130899206425
"T","68670",2009,"FEATHER R HATCHERY",398016,494,494,1201929,1600933,0.248615026362752
"T","68671",2009,"FEATHER R HATCHERY",392330,0,987,1181282,1574599,0.249161850096437
"T","68672",2009,"FEATHER R HATCHERY",400675,0,981,1206374,1608030,0.249171346305728
"T","68675",2009,"FEATHER R HATCHERY",118879,2468,987,0,122334,0.971757647097291
"T","68695",2009,"FEATHER R HATCHERY",89066,505,216,270205,359992,0.247411053578968
"T","68674",2010,"FEATHER R HATCHERY",143768,0,683,436000,580451,0.247683266976885
"T","68692",2010,"FEATHER R HATCHERY",9072,0,43,27378,36493,0.248595621078015
"T","68702",2010,"FEATHER R HATCHERY",41584,0,368,0,41952,0.991228070175439
"T","68709",2010,"FEATHER R HATCHERY",166322,201,770,502614,669907,0.248276253270976
"T","68736",2010,"FEATHER R HATCHERY",15640,35,52,0,15727,0.994468112163795
"T","68746",2010,"FEATHER R HATCHERY",534012,1136,2328,1620224,2157700,0.247491310191408
"T","68749",2010,"FEATHER R HATCHERY",393254,0,3341,1193167,1589762,0.247366586948235
"T","68750",2010,"FEATHER R HATCHERY",397492,160,1884,1202572,1602108,0.248105620844537
"T","68751",2010,"FEATHER R HATCHERY",397697,0,2497,1208384,1608578,0.247235135629108
"T","68752",2010,"FEATHER R HATCHERY",403277,0,1666,1217458,1622401,0.24856801740137
"T","68753",2010,"FEATHER R HATCHERY",170345,380,570,0,171295,0.994454012084416
"T","68754",2010,"FEATHER R HATCHERY",109221,0,894,331207,441322,0.24748596263046
"T","60388",2011,"FEATHER R HATCHERY",457906,1713,1437759,0,1897378,0.241336201853294
"T","60384",2011,"FEATHER R HATCHERY",9933,22,12,0,9967,0.99658874285141
"T","60374",2011,"FEATHER R HATCHERY",168623,373,186,0,169182,0.996695865990472
"T","60395",2011,"FEATHER R HATCHERY",276116,0,830489,0,1106605,0.24951631340903
"T","69504",2011,"FEATHER R HATCHERY",98241,109,217,0,98567,0.996692605030081
"T","60447",2012,"FEATHER R HATCHERY",9918,0,66,44,10028,0.989030714000798
"T","60464",2012,"FEATHER R HATCHERY",526043,0,3093,1594684,2123820,0.24768718629639
"T","60465",2012,"FEATHER R HATCHERY",392724,0,1755,1183506,1577985,0.248876890464738
"T","60466",2012,"FEATHER R HATCHERY",270906,906,815234,0,1087046,0.249213004785446
"T","60467",2012,"FEATHER R HATCHERY",263432,313,625,794824,1059194,0.248709868069494
"T","60469",2012,"FEATHER R HATCHERY",236800,0,2676,1070,240546,0.984427095025484
"T","60470",2012,"FEATHER R HATCHERY",90677,0,909,202,91788,0.987896021266397
"T","60471",2012,"FEATHER R HATCHERY",96832,112,2233,223,99400,0.974164989939638
"T","60472",2012,"FEATHER R HATCHERY",97760,201,704,805,99470,0.982808887101639
"T","60468",2012,"FEATHER R HATCHERY",412360,915,2286,457,416018,0.991207111230764
"T","60473",2012,"FEATHER R HATCHERY",99192,224,783,335,100534,0.986651282153301
"T","62782",2002,"FEATHER R HATCHERY",24923,0,771,0,25694,0.969992994473418
"T","62783",2002,"FEATHER R HATCHERY",25317,0,783,0,26100,0.97
"T","62784",2002,"FEATHER R HATCHERY",25014,0,773,0,25787,0.970023655330205
"T","601080801",2002,"FEATHER R HATCHERY",25475,0,1483,0,26958,0.944988500630611
"T","601080802",2002,"FEATHER R HATCHERY",25292,0,385,0,25677,0.985006036530747
"T","601080803",2002,"FEATHER R HATCHERY",24992,0,381,0,25373,0.98498403815079
"T","601080804",2002,"FEATHER R HATCHERY",24505,0,1564,0,26069,0.940005370363267
"T","601080805",2002,"FEATHER R HATCHERY",24589,0,1509,0,26098,0.942179477354587
"T","601080806",2002,"FEATHER R HATCHERY",25266,0,781,0,26047,0.970015740776289
"T","601080807",2002,"FEATHER R HATCHERY",25209,0,780,0,25989,0.969987302320212
"T","601090000",2002,"FEATHER R HATCHERY",25815,0,130,0,25945,0.994989400655232
"T","601090001",2002,"FEATHER R HATCHERY",26026,0,131,0,26157,0.994991780402951
"T","601070706",2001,"FEATHER R HATCHERY",26463,0,1218,0,27681,0.95599869946895
"T","601070707",2001,"FEATHER R HATCHERY",22337,0,1028,0,23365,0.956002567943505
"T","62697",2001,"FEATHER R HATCHERY",45972,0,1179,0,47151,0.974995228096965
"T","62698",2001,"FEATHER R HATCHERY",43676,0,2154,0,45830,0.953000218197687
"T","62726",2001,"FEATHER R HATCHERY",23630,0,606,0,24236,0.974995873906585
"T","62727",2001,"FEATHER R HATCHERY",22705,0,346,0,23051,0.984989805214524
"T","62728",2001,"FEATHER R HATCHERY",22714,0,346,0,23060,0.984995663486557
"T","62729",2001,"FEATHER R HATCHERY",22695,0,346,0,23041,0.984983290655787
"T","62730",2001,"FEATHER R HATCHERY",44565,0,224,0,44789,0.994998772019916
"T","62305",2005,"FEATHER R HATCHERY",24701,0,377,0,25078,0.984966903261823
"T","62306",2005,"FEATHER R HATCHERY",25700,0,0,0,25700,1
"T","62307",2005,"FEATHER R HATCHERY",26200,0,0,0,26200,1
"T","62308",2005,"FEATHER R HATCHERY",25733,0,130,0,25863,0.994973514286819
"T","62314",2005,"FEATHER R HATCHERY",14112,0,288,0,14400,0.98
"T","62315",2005,"FEATHER R HATCHERY",12544,0,256,0,12800,0.98
"T","62710",2000,"FEATHER R HATCHERY",20258,0,102,0,20360,0.994990176817289
"T","62711",2000,"FEATHER R HATCHERY",20398,0,102,0,20500,0.995024390243902
"T","62712",2000,"FEATHER R HATCHERY",19810,0,100,0,19910,0.994977398292315
"T","62713",2000,"FEATHER R HATCHERY",20129,0,101,0,20230,0.995007414730598
"T","53830",1999,"FEATHER R HATCHERY",23352,0,772,0,24124,0.967998673520146
"T","62651",1999,"FEATHER R HATCHERY",15770,0,289,0,16059,0.982003860763435
"T","62652",1999,"FEATHER R HATCHERY",15541,0,285,0,15826,0.981991659294831
"T","601061005",1999,"FEATHER R HATCHERY",24857,0,1036,0,25893,0.959989186266558
"T","501020810",1999,"FEATHER R HATCHERY",26033,0,131,0,26164,0.994993120317994
"T","62650",1999,"FEATHER R HATCHERY",17064,0,313,0,17377,0.981987684870806
"T","62655",1999,"FEATHER R HATCHERY",25005,0,253,0,25258,0.989983371605036
"T","501020807",1999,"FEATHER R HATCHERY",21419,0,282,0,21701,0.987005207133312
"T","501040407",2003,"FEATHER R HATCHERY",24835,0,1585,0,26420,0.94000757002271
"T","501040406",2003,"FEATHER R HATCHERY",25101,0,1602,0,26703,0.940006740815639
"T","501040404",2003,"FEATHER R HATCHERY",24556,0,1567,0,26123,0.940014546568158
"T","51998",2003,"FEATHER R HATCHERY",23828,0,2072,0,25900,0.92
"T","51999",2003,"FEATHER R HATCHERY",24304,0,2113,0,26417,0.920013627588295
"T","52064",2003,"FEATHER R HATCHERY",25749,0,1355,0,27104,0.950007378984652
"T","52066",2003,"FEATHER R HATCHERY",26291,0,537,0,26828,0.979983599224691
"T","601010909",2005,"FEATHER R HATCHERY",27466,0,277,0,27743,0.990015499405255
"T","601010907",2005,"FEATHER R HATCHERY",27425,0,277,0,27702,0.990000721969533
"T","601010905",2005,"FEATHER R HATCHERY",24206,0,244,0,24450,0.990020449897751
"T","601010906",2005,"FEATHER R HATCHERY",26933,0,272,0,27205,0.990001837897445
"T","601010908",2005,"FEATHER R HATCHERY",27616,0,279,0,27895,0.98999820756408
"T","52068",2003,"FEATHER R HATCHERY",25558,0,790,0,26348,0.970016699559739
"T","52069",2003,"FEATHER R HATCHERY",25666,0,794,0,26460,0.969992441421013
"T","501040405",2003,"FEATHER R HATCHERY",24687,0,1567,0,26254,0.940313856936086
"T","52065",2003,"FEATHER R HATCHERY",23819,0,1254,0,25073,0.949986040760978
"T","601010309",2004,"FEATHER R HATCHERY",24990,0,773,0,25763,0.969995730310911
"T","601010400",2004,"FEATHER R HATCHERY",25340,0,784,0,26124,0.969989281886388
"T","62431",2004,"FEATHER R HATCHERY",25443,0,258,0,25701,0.989961480098051
"T","601080902",2006,"FEATHER R HATCHERY",26511,0,268,0,26779,0.989992158034281
"T","601080903",2006,"FEATHER R HATCHERY",27878,0,282,0,28160,0.989985795454545
"T","601080904",2006,"FEATHER R HATCHERY",26013,0,23,0,26036,0.999116607773852
"T","601080908",2006,"FEATHER R HATCHERY",25644,0,129,0,25773,0.994994761960191
"T","601080909",2006,"FEATHER R HATCHERY",25881,0,130,0,26011,0.995002114490023
"T","62316",2006,"FEATHER R HATCHERY",23532,0,853,0,24385,0.965019479188025
"T","62317",2006,"FEATHER R HATCHERY",25283,0,917,0,26200,0.965
"T","62318",2006,"FEATHER R HATCHERY",24236,0,1142,0,25378,0.955000394042084
"T","62319",2006,"FEATHER R HATCHERY",23591,0,1112,0,24703,0.954985224466664
"T","62320",2006,"FEATHER R HATCHERY",23494,0,479,0,23973,0.980019188253452
"T","62321",2006,"FEATHER R HATCHERY",24002,0,490,0,24492,0.979993467254614
"T","62322",2006,"FEATHER R HATCHERY",12331,0,316,0,12647,0.975013837273662
"T","62323",2006,"FEATHER R HATCHERY",12546,0,322,0,12868,0.974976686353746
"T","62325",2006,"FEATHER R HATCHERY",12996,0,0,0,12996,1
"T","62326",2006,"FEATHER R HATCHERY",12834,0,130,0,12964,0.989972230792965
"T","62327",2006,"FEATHER R HATCHERY",12987,0,131,0,13118,0.990013721603903
"T","601010403",2004,"FEATHER R HATCHERY",24726,0,1302,0,26028,0.949976947902259
"T","601010404",2004,"FEATHER R HATCHERY",24665,0,1299,0,25964,0.949969188106609
"T","601010405",2004,"FEATHER R HATCHERY",25511,0,389,0,25900,0.984980694980695
"T","60364",2007,"FEATHER R HATCHERY",25405,0,128,0,25533,0.994986879724278
"T","608020101",2007,"FEATHER R HATCHERY",27743,0,84,0,27827,0.996981349049484
"T","608020104",2007,"FEATHER R HATCHERY",27687,0,28,0,27715,0.998989716759877
"T","60359",2007,"FEATHER R HATCHERY",24499,0,0,0,24499,1
"T","60360",2007,"FEATHER R HATCHERY",25942,0,0,0,25942,1
"T","60362",2007,"FEATHER R HATCHERY",25532,0,129,0,25661,0.994972916098359
"T","60363",2007,"FEATHER R HATCHERY",24990,0,126,0,25116,0.994983277591973
"T","60365",2007,"FEATHER R HATCHERY",29145,0,147,0,29292,0.994981564932405
"T","60366",2007,"FEATHER R HATCHERY",28518,0,144,0,28662,0.994975926313586
"T","60368",2007,"FEATHER R HATCHERY",25494,0,129,0,25623,0.994965460718885
"T","608020007",2007,"FEATHER R HATCHERY",27315,0,137,0,27452,0.995009471076789
"T","608020008",2007,"FEATHER R HATCHERY",26656,0,134,0,26790,0.994998133631952
"T","608020009",2007,"FEATHER R HATCHERY",26581,0,134,0,26715,0.994984091334456
"T","608020100",2007,"FEATHER R HATCHERY",26196,0,132,0,26328,0.994986326344576
"T","608020103",2007,"FEATHER R HATCHERY",27002,0,28,0,27030,0.998964113947466
"T","60367",2007,"FEATHER R HATCHERY",25823,0,130,0,25953,0.994990945170115
"T","608020102",2007,"FEATHER R HATCHERY",27260,0,83,0,27343,0.996964488168818
"T","55449",2011,"FEATHER R HATCHERY",1231,0,0,0,1231,1
"T","60680",2021,"FEATHER R HATCHERY",88526,0,266425,0,354951,0.249403438784508
"T","62886",2021,"FEATHER R HATCHERY",83269,0,247336,0,330605,0.251868544032909
"T","62887",2021,"FEATHER R HATCHERY",82094,0,247058,0,329152,0.249410606649815
"T","62890",2021,"FEATHER R HATCHERY",82937,629,209,252304,336079,0.246778287247939
"T","62891",2021,"FEATHER R HATCHERY",83880,210,252895,0,336985,0.248913156371945
"T","62892",2021,"FEATHER R HATCHERY",82684,0,207,250247,333138,0.248197443702009
"T","62893",2021,"FEATHER R HATCHERY",82954,209,209,251930,335302,0.247400850576495
"T","62894",2021,"FEATHER R HATCHERY",84210,0,253333,0,337543,0.249479325597035
"T","61957",2021,"FEATHER R HATCHERY",253495,567,425,760427,1014914,0.249769931245406
"T","62895",2021,"FEATHER R HATCHERY",83532,0,251453,0,334985,0.249360419123244
"T","61532",2021,"FEATHER R HATCHERY",86773,0,260685,0,347458,0.249736658819195
"T","62888",2021,"FEATHER R HATCHERY",84970,213,256036,0,341219,0.249018958498794
"T","62889",2021,"FEATHER R HATCHERY",83701,211,254864,0,338776,0.24706885965948
"T","62896",2021,"FEATHER R HATCHERY",83047,0,253144,0,336191,0.247023269510487
"T","61948",2021,"FEATHER R HATCHERY",93608,0,282085,0,375693,0.249160884019665
"T","61951",2021,"FEATHER R HATCHERY",98533,0,296700,0,395233,0.249303575359345
"T","61954",2021,"FEATHER R HATCHERY",251334,1114,836,754745,1008029,0.249332112468987
"T","61958",2021,"FEATHER R HATCHERY",248617,0,748624,0,997241,0.249304832031575
"T","62384",2021,"FEATHER R HATCHERY",199938,0,0,0,199938,1
"T","62897",2021,"FEATHER R HATCHERY",83790,0,252020,0,335810,0.249516095411096
"T","61530",2019,"FEATHER R HATCHERY",67460,0,606,204604,272670,0.247405288443907
"T","61588",2019,"FEATHER R HATCHERY",82758,345,689,253133,336925,0.24562736514061
"T","61589",2019,"FEATHER R HATCHERY",83142,93,372,252103,335710,0.247660182895952
"T","61590",2019,"FEATHER R HATCHERY",87792,98,264458,0,352348,0.249162759544541
"T","61591",2019,"FEATHER R HATCHERY",84318,0,283,254871,339472,0.248379836923222
"T","61596",2019,"FEATHER R HATCHERY",84548,0,569,256256,341373,0.247670436736356
"T","61592",2019,"FEATHER R HATCHERY",84409,94,94,254311,338908,0.249061692258666
"T","61593",2019,"FEATHER R HATCHERY",87656,0,788,266590,355034,0.246894663609682
"T","61594",2019,"FEATHER R HATCHERY",83673,0,846,254467,338986,0.246833202551138
"T","62048",2019,"FEATHER R HATCHERY",248810,0,1112,750878,1000800,0.248611111111111
"T","62049",2019,"FEATHER R HATCHERY",245996,553,1105,748548,996202,0.246933854780456
"T","62050",2019,"FEATHER R HATCHERY",260298,0,2045,791507,1053850,0.246997200740143
"T","61595",2019,"FEATHER R HATCHERY",83024,281,374,253735,337414,0.246059736703278
"T","608000904",2015,"FEATHER R HATCHERY",6163,0,0,0,6163,1
"T","60007",2022,"FEATHER R HATCHERY",83488,0,2582,258330,344400,0.242415795586527
"T","60008",2022,"FEATHER R HATCHERY",82863,0,753,252117,335733,0.246812198979546
"T","60009",2022,"FEATHER R HATCHERY",83432,0,1013,254254,338699,0.246330812904673
"T","60010",2022,"FEATHER R HATCHERY",84334,0,595,255016,339945,0.248081307270294
"T","60017",2022,"FEATHER R HATCHERY",81026,0,489,244704,326219,0.248379156333629
"T","60019",2022,"FEATHER R HATCHERY",251093,0,1008,756983,1009084,0.248832604619635
"T","60020",2022,"FEATHER R HATCHERY",249311,0,1253,752699,1003263,0.24850014403003
"T","60021",2022,"FEATHER R HATCHERY",249039,0,1503,753639,1004181,0.248002103206494
"T","60022",2022,"FEATHER R HATCHERY",200828,0,604,0,201432,0.997001469478534
"T","60660",2022,"FEATHER R HATCHERY",126502,0,432,381177,508111,0.248965285144388
"T","60973",2022,"FEATHER R HATCHERY",248521,0,748,748163,997432,0.249160845050089
"T","61550",2022,"FEATHER R HATCHERY",95585,0,286687,0,382272,0.25004447095262
"T","62070",2022,"FEATHER R HATCHERY",95132,0,285545,0,380677,0.249902148015247
"T","60013",2022,"FEATHER R HATCHERY",82672,0,1454,252957,337083,0.24525710285004
"T","60014",2022,"FEATHER R HATCHERY",82379,0,1510,251985,335874,0.245267570577062
"T","60015",2022,"FEATHER R HATCHERY",83438,0,1125,253914,338477,0.246510102606676
"T","60016",2022,"FEATHER R HATCHERY",83993,0,763,254532,339288,0.247556648039424
"T","60018",2022,"FEATHER R HATCHERY",83439,0,250488,0,333927,0.249871978007169
"T","60011",2022,"FEATHER R HATCHERY",84085,0,109,252788,336982,0.249523713432765
"T","62883",2022,"FEATHER R HATCHERY",123756,0,2268,378314,504338,0.24538305660093
"T","60012",2022,"FEATHER R HATCHERY",81115,0,1825,249096,332036,0.244295799250684
