"record_code","tag_code_or_release_id","brood_year","hatchery_location_name","cwt_1st_mark_count","cwt_2nd_mark_count","non_cwt_1st_mark_count","non_cwt_2nd_mark_count","Total_Released","Phi"
"T","60474",2012,"NIMBUS FISH HATCHERY",373919,0,1194,1127275,1502388,0.248883111419953
"T","60475",2012,"NIMBUS FISH HATCHERY",373607,0,1121596,0,1495203,0.249870418933081
"T","60476",2012,"NIMBUS FISH HATCHERY",279070,311,622,0,280003,0.996667892844005
"T","68769",2010,"NIMBUS FISH HATCHERY",268755,0,597,1819,271171,0.991090492714929
"T","68770",2010,"NIMBUS FISH HATCHERY",201266,0,604384,0,805650,0.249818159250295
"T","68783",2010,"NIMBUS FISH HATCHERY",34972,0,104989,0,139961,0.249869606533249
"T","60461",2020,"NIMBUS FISH HATCHERY",166406,373,559,503148,670486,0.248187135898438
"T","60665",2014,"NIMBUS FISH HATCHERY",160978,0,483985,0,644963,0.249592612289387
"T","61536",2020,"NIMBUS FISH HATCHERY",166241,743,501477,0,668461,0.248692145091486
"T","62094",2020,"NIMBUS FISH HATCHERY",34722,0,39,104439,139200,0.249439655172414
"T","61467",2017,"NIMBUS FISH HATCHERY",162236,0,181,487691,650108,0.249552382065749
"T","61468",2017,"NIMBUS FISH HATCHERY",162200,177,488940,0,651317,0.249033880583495
"T","61469",2017,"NIMBUS FISH HATCHERY",169743,0,187,511755,681685,0.249005038984282
"T","61470",2017,"NIMBUS FISH HATCHERY",170406,0,572,513338,684316,0.249016536220109
"T","61466",2017,"NIMBUS FISH HATCHERY",166838,0,500813,0,667651,0.249888040308485
"T","061575*1",2018,"NIMBUS FISH HATCHERY",11865,0,35630,0,47495,0.249815770081061
"T","061575*2",2020,"NIMBUS FISH HATCHERY",169117,189,189,509447,678942,0.249089023804684
"T","62364",2020,"NIMBUS FISH HATCHERY",139898,0,156,421095,561149,0.24930633396834
"T","62374",2020,"NIMBUS FISH HATCHERY",35341,40,106144,0,141525,0.249715597950892
"T","62375",2020,"NIMBUS FISH HATCHERY",35198,119,277,106782,142376,0.247218632353767
"T","61465",2017,"NIMBUS FISH HATCHERY",167209,0,501867,0,669076,0.249910324088743
"T","62362",2020,"NIMBUS FISH HATCHERY",130532,440,1027,396291,528290,0.247083987961158
"T","62363",2020,"NIMBUS FISH HATCHERY",134300,150,403515,0,537965,0.249644493600885
"T","60667",2014,"NIMBUS FISH HATCHERY",158190,711,711,478836,638448,0.247772723855349
"T","60664",2014,"NIMBUS FISH HATCHERY",166925,0,187,501853,668965,0.249527254789115
"T","60668",2014,"NIMBUS FISH HATCHERY",163181,914,183,492834,657112,0.248330573783465
"T","61994",2018,"NIMBUS FISH HATCHERY",199285,0,580,0,199865,0.997098041177795
"T","60997",2016,"NIMBUS FISH HATCHERY",154232,0,178,463492,617902,0.249605924564089
"T","60998",2016,"NIMBUS FISH HATCHERY",151232,0,453872,0,605104,0.249927285227002
"T","60999",2016,"NIMBUS FISH HATCHERY",147768,0,157,443935,591860,0.249667151015443
"T","61201",2016,"NIMBUS FISH HATCHERY",137968,151,414576,0,552695,0.249627733198238
"T","61202",2016,"NIMBUS FISH HATCHERY",145641,0,437075,0,582716,0.249934788130067
"T","61203",2016,"NIMBUS FISH HATCHERY",131891,0,585,398011,530487,0.248622492162862
"T","62555",2000,"NIMBUS FISH HATCHERY",41150,0,9285,0,50435,0.815901655596312
"T","62666",2001,"NIMBUS FISH HATCHERY",238195,0,35749,0,273944,0.869502526063721
"T","62667",2001,"NIMBUS FISH HATCHERY",237231,0,35713,895,273839,0.866315608806635
"T","62668",2001,"NIMBUS FISH HATCHERY",238193,0,35751,0,273944,0.869495225301521
"T","61953",2018,"NIMBUS FISH HATCHERY",139476,0,418740,0,558216,0.249860269143127
"T","61909",2018,"NIMBUS FISH HATCHERY",9102,0,30,27403,36535,0.24913097030245
"T","61995",2018,"NIMBUS FISH HATCHERY",199833,0,441,601217,801491,0.249326567609618
"T","61998",2018,"NIMBUS FISH HATCHERY",139618,0,772,421455,561845,0.248499141222223
"T","61999",2018,"NIMBUS FISH HATCHERY",139272,0,461,419408,559141,0.249082074110108
"T","61996",2018,"NIMBUS FISH HATCHERY",199660,0,440,600700,800800,0.249325674325674
"T","61997",2018,"NIMBUS FISH HATCHERY",199072,0,880,600210,800162,0.248789620101929
"T","62562",2003,"NIMBUS FISH HATCHERY",33714,0,4557,0,38271,0.880928117896057
"T","62563",2003,"NIMBUS FISH HATCHERY",10626,0,1442,0,12068,0.880510440835267
"T","62565",2003,"NIMBUS FISH HATCHERY",18528,0,420,0,18948,0.977834072197593
"T","62566",2003,"NIMBUS FISH HATCHERY",18758,0,424,0,19182,0.977895944114274
"T","62564",2003,"NIMBUS FISH HATCHERY",11965,0,263,0,12228,0.978491985606804
"T","63833",2000,"NIMBUS FISH HATCHERY",28396,0,14615,0,43011,0.660203203831578
"T","63838",2000,"NIMBUS FISH HATCHERY",5192,0,2690,0,7882,0.65871606191322
"T","65448",1982,"NIMBUS FISH HATCHERY",46615,0,3725,0,50340,0.926003178386969
"T","65455",2000,"NIMBUS FISH HATCHERY",98171,0,1226581,1204,1325956,0.0740379017101623
"T","65456",2000,"NIMBUS FISH HATCHERY",99528,0,285184,0,384712,0.258707812597475
"T","65457",2000,"NIMBUS FISH HATCHERY",99102,0,285185,807,385094,0.257344959931861
"T","65458",2000,"NIMBUS FISH HATCHERY",99297,0,322581,403,422281,0.235144370691554
"T","65459",2000,"NIMBUS FISH HATCHERY",99439,0,322581,403,422423,0.235401481453425
"T","65460",2000,"NIMBUS FISH HATCHERY",96371,0,1086133,2805,1185309,0.0813045374666015
"T","60575",2013,"NIMBUS FISH HATCHERY",35093,0,83,105352,140528,0.249722475236252
"T","60579",2013,"NIMBUS FISH HATCHERY",280082,0,660,842194,1122936,0.249419379198815
"T","60580",2013,"NIMBUS FISH HATCHERY",279616,0,838335,0,1117951,0.250114718802524
"T","60581",2013,"NIMBUS FISH HATCHERY",301628,0,320,904202,1206150,0.250075032127016
"T","65451",1983,"NIMBUS FISH HATCHERY",50114,0,558,0,50672,0.988988001263025
"T","65407",1986,"NIMBUS FISH HATCHERY",51891,0,524,0,52415,0.990002861776209
"T","65405",1985,"NIMBUS FISH HATCHERY",48920,0,5800,0,54720,0.894005847953216
"T","65449",1982,"NIMBUS FISH HATCHERY",47350,0,2650,0,50000,0.947
"T","65453",1984,"NIMBUS FISH HATCHERY",24276,0,1224,0,25500,0.952
"T","65450",1983,"NIMBUS FISH HATCHERY",49513,0,1062,0,50575,0.97900148294612
"T","65454",1984,"NIMBUS FISH HATCHERY",25103,0,697,0,25800,0.972984496124031
"T","65447",1982,"NIMBUS FISH HATCHERY",47320,0,2543,0,49863,0.949000260714357
"T","60748",2015,"NIMBUS FISH HATCHERY",177075,0,532283,0,709358,0.249627127628081
"T","60749",2015,"NIMBUS FISH HATCHERY",173167,0,519751,0,692918,0.249909801737002
"T","60750",2015,"NIMBUS FISH HATCHERY",173467,0,520635,0,694102,0.249915718439077
"T","60751",2015,"NIMBUS FISH HATCHERY",172272,0,517032,0,689304,0.249921660109328
"T","60752",2015,"NIMBUS FISH HATCHERY",173356,0,520432,0,693788,0.249868836013307
"T","60753",2015,"NIMBUS FISH HATCHERY",171941,0,516092,0,688033,0.249902257595203
"T","65452",1983,"NIMBUS FISH HATCHERY",48677,0,1923,0,50600,0.96199604743083
"T","65415",1988,"NIMBUS FISH HATCHERY",48207,0,237793,3417,289417,0.16656588935688
"T","65414",1988,"NIMBUS FISH HATCHERY",49848,0,218122,2243,270213,0.18447669061074
"T","65421",1989,"NIMBUS FISH HATCHERY",47663,0,273837,3181,324681,0.146799473945195
"T","65412",1988,"NIMBUS FISH HATCHERY",49400,0,279800,3381,332581,0.148535244045811
"T","65411",1987,"NIMBUS FISH HATCHERY",36325,0,209416,10973,256714,0.141499879243049
"T","65413",1988,"NIMBUS FISH HATCHERY",41125,0,188875,9992,239992,0.171359878662622
"T","65418",1989,"NIMBUS FISH HATCHERY",45384,0,229816,4902,280102,0.162026690277113
"T","65419",1989,"NIMBUS FISH HATCHERY",46156,0,244594,4616,295366,0.156267139752036
"T","65408",1986,"NIMBUS FISH HATCHERY",46516,0,5169,0,51685,0.89999032601335
"T","65410",1987,"NIMBUS FISH HATCHERY",43344,0,293162,8822,345328,0.125515451976092
"T","65420",1989,"NIMBUS FISH HATCHERY",46263,0,308937,3877,359077,0.128838661345617
"T","65406",1985,"NIMBUS FISH HATCHERY",53072,0,67200,3328,123600,0.429385113268608
"T","65409",1987,"NIMBUS FISH HATCHERY",46829,0,292929,5007,344765,0.135828752918655
"T","60663",2014,"NIMBUS FISH HATCHERY",163471,0,490875,0,654346,0.249823487879501
"T","60666",2014,"NIMBUS FISH HATCHERY",167082,370,501263,0,668715,0.249855319530742
"N","!08NBFH05001",2004,"NIMBUS FISH HATCHERY",0,0,91300,0,91300,0
"N","!08NBFH05002",2004,"NIMBUS FISH HATCHERY",0,0,136000,0,136000,0
"N","!08NBFH05003",2004,"NIMBUS FISH HATCHERY",0,0,154100,0,154100,0
"N","!08NBFH05004",2004,"NIMBUS FISH HATCHERY",0,0,290400,0,290400,0
"N","!08NBFH05005",2004,"NIMBUS FISH HATCHERY",0,0,289800,0,289800,0
"N","!08NBFH05006",2004,"NIMBUS FISH HATCHERY",0,0,142600,0,142600,0
"N","!08NBFH05007",2004,"NIMBUS FISH HATCHERY",0,0,152500,0,152500,0
"N","!08NBFH05008",2004,"NIMBUS FISH HATCHERY",0,0,1854000,0,1854000,0
"N","!08NBFH05009",2004,"NIMBUS FISH HATCHERY",0,0,253700,0,253700,0
"N","!08NBFH05010",2004,"NIMBUS FISH HATCHERY",0,0,400200,0,400200,0
"N","!08NBFH05011",2004,"NIMBUS FISH HATCHERY",0,0,524400,0,524400,0
"N","!08NBFH05012",2004,"NIMBUS FISH HATCHERY",0,0,143000,0,143000,0
"N","!08NBFH05013",2004,"NIMBUS FISH HATCHERY",0,0,138000,0,138000,0
"T","67008",2006,"NIMBUS FISH HATCHERY",401213,1353,1208429,0,1610995,0.24904670715924
"T","67009",2006,"NIMBUS FISH HATCHERY",394440,455,1185324,0,1580219,0.249610971643804
"T","67010",2006,"NIMBUS FISH HATCHERY",400691,449,1208190,1348,1610678,0.248771635298924
"T","67021",2006,"NIMBUS FISH HATCHERY",49755,94,149808,50,199707,0.249139990085475
"T","67001",2007,"NIMBUS FISH HATCHERY",312228,0,1105,940460,1253793,0.249026753220029
"T","68602",2007,"NIMBUS FISH HATCHERY",444826,0,1335029,0,1779855,0.249922606054988
"T","68603",2007,"NIMBUS FISH HATCHERY",461701,0,3303,1395855,1860859,0.248111759139193
"T","68640",2008,"NIMBUS FISH HATCHERY",264006,2997,2997,0,270000,0.9778
"T","68623",2008,"NIMBUS FISH HATCHERY",35062,20,121,105907,141110,0.248472822620651
"T","68638",2008,"NIMBUS FISH HATCHERY",400048,0,1201089,0,1601137,0.249852448603711
"T","68651",2008,"NIMBUS FISH HATCHERY",140649,0,1240,428423,570312,0.246617640870261
"T","68637",2008,"NIMBUS FISH HATCHERY",401196,427,1285,1209420,1612328,0.248830262824934
"T","68680",2009,"NIMBUS FISH HATCHERY",279383,0,838649,0,1118032,0.24988819640225
"N","!08NIM03-01",2002,"NIMBUS FISH HATCHERY",0,0,2864700,0,2864700,0
"N","!08NIM03-02",2002,"NIMBUS FISH HATCHERY",0,0,994300,0,994300,0
"N","!08NIM03-03",2002,"NIMBUS FISH HATCHERY",0,0,502300,0,502300,0
"N","!08NIM06-01",2005,"NIMBUS FISH HATCHERY",0,0,1441200,0,1441200,0
"N","!08NIM06-02",2005,"NIMBUS FISH HATCHERY",0,0,1561400,0,1561400,0
"T","68677",2009,"NIMBUS FISH HATCHERY",389432,0,494,1182114,1572040,0.247723976489148
"T","68678",2009,"NIMBUS FISH HATCHERY",343111,0,412,1031060,1374583,0.24961097292779
"T","68658",2009,"NIMBUS FISH HATCHERY",68144,0,253,205203,273600,0.24906432748538
"T","68679",2009,"NIMBUS FISH HATCHERY",268016,0,2274,4224,274514,0.976329076112694
"T","68767",2010,"NIMBUS FISH HATCHERY",366781,0,1100844,0,1467625,0.249914658035942
"T","68768",2010,"NIMBUS FISH HATCHERY",378804,1332,1140936,0,1521072,0.249037520906308
"T","68771",2010,"NIMBUS FISH HATCHERY",132125,0,517995,0,650120,0.203231711068726
"T","60396",2011,"NIMBUS FISH HATCHERY",131335,0,394268,0,525603,0.249874905584633
"T","60424",2011,"NIMBUS FISH HATCHERY",401994,0,1206787,0,1608781,0.24987490528543
"T","60425",2011,"NIMBUS FISH HATCHERY",275408,0,0,0,275408,1
"T","60426",2011,"NIMBUS FISH HATCHERY",196738,0,590589,0,787327,0.249880926222523
"T","60423",2011,"NIMBUS FISH HATCHERY",400789,0,925,1206210,1607924,0.249258671429744
"T","60372",2012,"NIMBUS FISH HATCHERY",182413,205,1025,551263,734906,0.248212696589768
"T","61209",2021,"NIMBUS FISH HATCHERY",11026,0,73,33298,44397,0.248350113746424
"T","62965",2021,"NIMBUS FISH HATCHERY",165665,366,183,499433,665647,0.248878159144411
"T","62966",2021,"NIMBUS FISH HATCHERY",168694,0,950,509254,678898,0.248482098930915
"T","62968",2021,"NIMBUS FISH HATCHERY",208383,707,235,628762,838087,0.248641250848659
"T","62969",2021,"NIMBUS FISH HATCHERY",209932,0,630548,0,840480,0.249776318294308
"T","62967",2021,"NIMBUS FISH HATCHERY",166889,0,501167,0,668056,0.249812889937371
"T","62970",2021,"NIMBUS FISH HATCHERY",220172,0,1463,665203,886838,0.248266312449399
"T","68208",2021,"NIMBUS FISH HATCHERY",5310,0,30,16019,21359,0.248607144529238
"T","68665",2021,"NIMBUS FISH HATCHERY",5631,19,6,16967,22623,0.248905980639173
"T","62052",2019,"NIMBUS FISH HATCHERY",199963,0,217,602043,802223,0.249261115674819
"T","62057",2019,"NIMBUS FISH HATCHERY",199880,0,601,0,200481,0.997002209685706
"T","60728",2019,"NIMBUS FISH HATCHERY",12410,14,37356,0,49780,0.249296906388108
"T","60992",2019,"NIMBUS FISH HATCHERY",11431,0,34347,0,45778,0.249705098518939
"T","62051",2019,"NIMBUS FISH HATCHERY",199499,0,444,600684,800627,0.249178456384808
"T","62053",2019,"NIMBUS FISH HATCHERY",197125,0,647,593851,791623,0.249013735073387
"T","62054",2019,"NIMBUS FISH HATCHERY",144708,161,435267,0,580136,0.249438062799068
"T","62055",2019,"NIMBUS FISH HATCHERY",143163,162,1937,436230,581492,0.246199431806456
"T","62056",2019,"NIMBUS FISH HATCHERY",141459,0,424767,0,566226,0.249827807271302
