"record_code","tag_code_or_release_id","brood_year","hatchery_location_name","cwt_1st_mark_count","cwt_2nd_mark_count","non_cwt_1st_mark_count","non_cwt_2nd_mark_count","Total_Released","Phi"
"N","!07200300040",2002,"COLEMAN NFH",0,0,1685414,0,1685414,0
"T","55599",2012,"COLEMAN NFH",200609,0,529,603897,805035,0.249192892234499
"T","55604",2012,"COLEMAN NFH",209679,0,631886,0,841565,0.249153660145087
"T","55605",2012,"COLEMAN NFH",209004,0,627493,0,836497,0.24985624574864
"T","55596",2012,"COLEMAN NFH",205913,0,618233,0,824146,0.249850147910686
"T","55593",2012,"COLEMAN NFH",101247,0,302224,0,403471,0.250939968424001
"T","55594",2012,"COLEMAN NFH",110916,847,335565,0,447328,0.247952285571214
"T","55595",2012,"COLEMAN NFH",112454,278,557,340057,453346,0.248053363214851
"T","55606",2012,"COLEMAN NFH",218130,0,1077,658094,877301,0.248637582768058
"T","55607",2012,"COLEMAN NFH",222903,0,1698,674292,898893,0.247975009261392
"T","55608",2012,"COLEMAN NFH",305185,0,1553,921144,1227882,0.248545870042887
"T","55609",2012,"COLEMAN NFH",325812,0,2455,985869,1314136,0.247928677092782
"T","55610",2012,"COLEMAN NFH",323396,0,971012,0,1294408,0.249840853888418
"T","55597",2012,"COLEMAN NFH",202819,0,609088,0,811907,0.249805704347912
"T","55598",2012,"COLEMAN NFH",208281,0,1066,628602,837949,0.248560473250759
"N","!07198500142",1984,"COLEMAN NFH",0,0,656640,0,656640,0
"N","!07198500143",1984,"COLEMAN NFH",0,0,1211040,0,1211040,0
"N","!07197900032",1978,"COLEMAN NFH",0,0,827504,0,827504,0
"N","!07198500144",1984,"COLEMAN NFH",0,0,169040,0,169040,0
"N","!07198500146",1984,"COLEMAN NFH",0,0,1458082,0,1458082,0
"T","56059",2016,"COLEMAN NFH",112158,1280,3841,353282,470561,0.238349544479887
"T","56061",2016,"COLEMAN NFH",110314,277,332274,0,442865,0.249091709663216
"T","56062",2016,"COLEMAN NFH",111377,267,338367,0,450011,0.24749839448369
"T","56069",2016,"COLEMAN NFH",113461,0,288,342728,456477,0.248557977729437
"T","56070",2016,"COLEMAN NFH",92705,0,279494,0,372199,0.249073748183096
"T","56071",2016,"COLEMAN NFH",110955,0,334241,0,445196,0.249227306624498
"T","56067",2016,"COLEMAN NFH",104797,0,2166,322374,429337,0.244090306682163
"T","56074",2016,"COLEMAN NFH",111476,0,550,337534,449560,0.247966900969837
"T","56076",2016,"COLEMAN NFH",102370,0,772,310771,413913,0.247322504970851
"T","56078",2016,"COLEMAN NFH",98319,0,261,297096,395676,0.248483607800321
"N","!07197900034",1977,"COLEMAN NFH",0,0,535143,0,535143,0
"N","!07200300042",2002,"COLEMAN NFH",0,0,3588184,0,3588184,0
"T","501020208",1996,"COLEMAN NFH",30589,0,400478,4571,435638,0.0702165559478282
"T","501020302",1996,"COLEMAN NFH",30619,0,369456,3784,403859,0.0758160645175668
"N","!07198000042",1979,"COLEMAN NFH",0,0,190000,0,190000,0
"T","501020114",1995,"COLEMAN NFH",295384,0,3764223,42971,4102578,0.0719996061013343
"T","501020313",1996,"COLEMAN NFH",34257,0,392376,2578,429211,0.0798138910698934
"T","501020213",1996,"COLEMAN NFH",28501,0,403354,8039,439894,0.0647906086466285
"T","501020307",1996,"COLEMAN NFH",34829,0,398205,1451,434485,0.0801615705950723
"T","501020305",1996,"COLEMAN NFH",34517,0,387384,704,422605,0.0816767430579383
"N","!07198400087",1983,"COLEMAN NFH",0,0,150762,0,150762,0
"N","!07198400089",1983,"COLEMAN NFH",0,0,150000,0,150000,0
"N","!07198500163",1984,"COLEMAN NFH",0,0,2415350,0,2415350,0
"N","!07198400090",1983,"COLEMAN NFH",0,0,3507995,0,3507995,0
"N","!07198700096",1986,"COLEMAN NFH",0,0,108283,0,108283,0
"T","56573",2020,"COLEMAN NFH",92337,0,0,0,92337,1
"T","56572",2020,"COLEMAN NFH",93823,0,471,0,94294,0.995004984410461
"T","56568",2020,"COLEMAN NFH",111159,0,546,336560,448265,0.247976085574381
"T","56569",2020,"COLEMAN NFH",108591,0,1200,330826,440617,0.246452134166408
"T","56567",2020,"COLEMAN NFH",109302,0,328105,0,437407,0.249886261536738
"T","56562",2020,"COLEMAN NFH",112979,0,340366,0,453345,0.249211968809626
"T","56564",2020,"COLEMAN NFH",120923,0,364168,0,485091,0.249279001259557
"T","56556",2020,"COLEMAN NFH",114008,0,342341,0,456349,0.24982633905191
"T","56557",2020,"COLEMAN NFH",109411,0,329806,0,439217,0.249104656695893
"T","56558",2020,"COLEMAN NFH",109022,0,328464,0,437486,0.249201117292896
"T","56559",2020,"COLEMAN NFH",112760,0,301,340655,453716,0.248525509349461
"T","56560",2020,"COLEMAN NFH",105787,0,267,319600,425654,0.248528147274547
"T","56555",2020,"COLEMAN NFH",110906,0,281,333796,444983,0.249236487686046
"T","56554",2020,"COLEMAN NFH",111184,0,338,336115,447637,0.248379825617632
"T","56561",2020,"COLEMAN NFH",117589,0,354312,0,471901,0.249181502052337
"T","56553",2020,"COLEMAN NFH",113466,0,563,343539,457568,0.247976257080915
"T","56552",2020,"COLEMAN NFH",114713,0,296,345306,460315,0.249205435408362
"T","56551",2020,"COLEMAN NFH",111183,0,282,334735,446200,0.249177498879426
"T","56563",2020,"COLEMAN NFH",103437,0,311742,0,415179,0.249138323470118
"T","56550",2020,"COLEMAN NFH",116471,0,349706,0,466177,0.249842870840904
"T","56542",2020,"COLEMAN NFH",102396,0,308806,0,411202,0.249016298558859
"T","56570",2020,"COLEMAN NFH",92718,0,0,0,92718,1
"T","56543",2020,"COLEMAN NFH",105244,0,272,318002,423518,0.248499473458035
"T","56544",2020,"COLEMAN NFH",107520,0,323417,0,430937,0.249502827559481
"T","56545",2020,"COLEMAN NFH",116268,0,349153,0,465421,0.249812535317487
"T","56546",2020,"COLEMAN NFH",113219,0,341092,0,454311,0.249210342694762
"T","56547",2020,"COLEMAN NFH",117930,0,354065,0,471995,0.249854341677348
"T","56565",2020,"COLEMAN NFH",105095,0,316618,0,421713,0.249209770625994
"T","56566",2020,"COLEMAN NFH",122137,0,366820,0,488957,0.249790881406749
"T","56548",2020,"COLEMAN NFH",110621,0,332339,0,442960,0.249731352718078
"T","56571",2020,"COLEMAN NFH",90774,0,461,921,92156,0.985003689396241
"T","56549",2020,"COLEMAN NFH",115033,0,284,346235,461552,0.249230855894894
"T","50882",2001,"COLEMAN NFH",78815,0,348129,0,426944,0.184602664518063
"T","54472",2007,"COLEMAN NFH",346353,0,1040056,0,1386409,0.249820218997424
"T","501040204",2001,"COLEMAN NFH",72867,0,340,417767,490974,0.148413154260714
"T","501040203",2001,"COLEMAN NFH",72468,0,880,363543,436891,0.165872036732274
"T","50874",2001,"COLEMAN NFH",78255,314,320956,0,399525,0.19587009573869
"T","50879",2001,"COLEMAN NFH",75445,0,916,416403,492764,0.153105746361341
"T","50880",2001,"COLEMAN NFH",79730,0,403292,0,483022,0.165064945281995
"N","!07197600153",1975,"COLEMAN NFH",0,0,125733,0,125733,0
"N","!07198500141",1984,"COLEMAN NFH",0,0,201770,0,201770,0
"N","!07197500128",1974,"COLEMAN NFH",0,0,219600,0,219600,0
"N","!07199900091",1998,"COLEMAN NFH",0,0,478047,0,478047,0
"N","!07198700088",1986,"COLEMAN NFH",0,0,1494700,0,1494700,0
"N","!07198700089",1986,"COLEMAN NFH",0,0,349476,0,349476,0
"N","!07198600107",1985,"COLEMAN NFH",0,0,2044279,0,2044279,0
"N","!07198600114",1985,"COLEMAN NFH",0,0,1531200,0,1531200,0
"N","!07197900028",1977,"COLEMAN NFH",0,0,30600,0,30600,0
"N","!07197700132",1976,"COLEMAN NFH",0,0,1096809,0,1096809,0
"N","!07197700122",1976,"COLEMAN NFH",0,0,1597000,0,1597000,0
"N","!07197800132",1977,"COLEMAN NFH",0,0,1425908,0,1425908,0
"N","!07199200270",1991,"COLEMAN NFH",0,0,6134291,0,6134291,0
"N","!07199200271",1991,"COLEMAN NFH",0,0,2464377,0,2464377,0
"N","!07199200272",1991,"COLEMAN NFH",0,0,29481,0,29481,0
"N","!07197900030",1978,"COLEMAN NFH",0,0,42275,0,42275,0
"N","!07197900031",1978,"COLEMAN NFH",0,0,1013462,0,1013462,0
"N","!07197600127",1975,"COLEMAN NFH",0,0,15000,0,15000,0
"N","!07199100211",1990,"COLEMAN NFH",0,0,307819,0,307819,0
"N","!07199100212",1990,"COLEMAN NFH",0,0,324679,0,324679,0
"T","66219",1981,"COLEMAN NFH",86877,0,11624,0,98501,0.881991045776185
"T","501040905",2007,"COLEMAN NFH",24055,125,877,0,25057,0.96001117452209
"T","54468",2007,"COLEMAN NFH",226107,0,678787,0,904894,0.249871255638782
"T","54471",2007,"COLEMAN NFH",338491,0,438,1017136,1356065,0.249612666059518
"T","54399",2007,"COLEMAN NFH",110799,0,263,333599,444661,0.249176338828906
"T","501030601",2000,"COLEMAN NFH",58049,0,6094,415851,479994,0.120936928378271
"T","60305",1975,"COLEMAN NFH",162857,0,316134,0,478991,0.340000125263314
"T","60303",1975,"COLEMAN NFH",135210,0,392954,0,528164,0.256000030293621
"T","66017",1980,"COLEMAN NFH",84967,0,16510,0,101477,0.837303034185086
"T","60304",1975,"COLEMAN NFH",166331,0,419342,0,585673,0.28399977461826
"T","54464",2007,"COLEMAN NFH",227353,0,682784,0,910137,0.249800854157121
"T","54465",2007,"COLEMAN NFH",220907,260,664932,0,886099,0.249302843136038
"T","H60105",1980,"COLEMAN NFH",47019,0,9630,0,56649,0.830005825345549
"T","H60202",1981,"COLEMAN NFH",41753,0,7427,0,49180,0.84898332655551
"T","66029",1981,"COLEMAN NFH",43817,0,5526,0,49343,0.888008430780455
"T","66035",1982,"COLEMAN NFH",45343,0,4212,0,49555,0.915003531429725
"T","66034",1982,"COLEMAN NFH",44498,0,3817,0,48315,0.920997619786816
"T","66009",1976,"COLEMAN NFH",198632,0,46593,0,245225,0.809998980528086
"T","H60206",1981,"COLEMAN NFH",43673,0,8568,0,52241,0.835990888382688
"T","501010802",1992,"COLEMAN NFH",56721,0,6513,0,63234,0.897001613056267
"T","H60102",1980,"COLEMAN NFH",40916,0,14152,0,55068,0.743008643858502
"T","H60207",1981,"COLEMAN NFH",40508,0,8474,0,48982,0.82699767261443
"T","H60106",1980,"COLEMAN NFH",45949,0,5679,0,51628,0.890001549546758
"T","H60203",1981,"COLEMAN NFH",43248,0,6009,0,49257,0.878007186795785
"T","H60404",1983,"COLEMAN NFH",43883,0,6499,0,50382,0.871005517843674
"T","501021309",1999,"COLEMAN NFH",10154,0,534,0,10688,0.950037425149701
"T","501010801",1992,"COLEMAN NFH",54398,0,6111,0,60509,0.899006759325059
"T","501021308",1999,"COLEMAN NFH",10365,0,321,0,10686,0.969960696238068
"T","H60705",1985,"COLEMAN NFH",51426,0,1050,0,52476,0.979990852961354
"T","H60101",1980,"COLEMAN NFH",35905,0,18662,0,54567,0.657998423955871
"T","H60605",1984,"COLEMAN NFH",52313,0,1287,0,53600,0.975988805970149
"T","66024",1981,"COLEMAN NFH",49003,0,2797,0,51800,0.946003861003861
"T","66041",1983,"COLEMAN NFH",50921,0,1145,0,52066,0.978008681289133
"T","H60505",1984,"COLEMAN NFH",49155,0,7345,0,56500,0.87
"T","66028",1981,"COLEMAN NFH",44308,0,5589,0,49897,0.887989257871215
"T","H60707",1986,"COLEMAN NFH",52977,0,1303,0,54280,0.97599484156227
"T","66040",1983,"COLEMAN NFH",51948,0,1169,0,53117,0.977991979968748
"T","H60504",1983,"COLEMAN NFH",47855,0,4503,0,52358,0.913995950953054
"T","52056",1989,"COLEMAN NFH",51533,0,679,0,52212,0.98699532674481
"T","501011205",1994,"COLEMAN NFH",45472,0,5449,0,50921,0.892991103866774
"T","H60607",1985,"COLEMAN NFH",50961,0,2013,0,52974,0.96200022652622
"T","H60405",1983,"COLEMAN NFH",48460,0,2284,0,50744,0.954989752483052
"T","H60503",1983,"COLEMAN NFH",48157,0,2965,0,51122,0.942001486639803
"T","H60703",1985,"COLEMAN NFH",53831,0,1494,0,55325,0.972995933122458
"T","H60706",1986,"COLEMAN NFH",48733,0,3056,0,51789,0.940991330205256
"T","H60604",1984,"COLEMAN NFH",51985,0,1115,0,53100,0.979001883239171
"T","H60506",1984,"COLEMAN NFH",51201,0,6199,0,57400,0.892003484320558
"N","!07199100215",1990,"COLEMAN NFH",0,0,271156,0,271156,0
"T","601110208",1991,"COLEMAN NFH",21253,0,4291,0,25544,0.832015346069527
"T","601110206",1991,"COLEMAN NFH",24862,0,507,0,25369,0.98001497891127
"T","601110207",1991,"COLEMAN NFH",26219,0,1380,0,27599,0.949998188340157
"T","66008",1976,"COLEMAN NFH",199639,0,19745,0,219384,0.909997994384276
"T","B50206",1987,"COLEMAN NFH",48299,0,7026,0,55325,0.873004970628107
"T","501021114",1998,"COLEMAN NFH",36245,0,1315,405394,442954,0.0818256523250721
"T","H60205",1981,"COLEMAN NFH",40699,0,9177,0,49876,0.81600368914909
"T","H60104",1980,"COLEMAN NFH",49705,0,8091,0,57796,0.860007612983598
"T","H60301",1981,"COLEMAN NFH",39321,0,11350,0,50671,0.776005999486886
"T","H60201",1980,"COLEMAN NFH",36901,0,15815,0,52716,0.699996206085439
"T","501021006",1998,"COLEMAN NFH",27888,1430,6436,445961,481715,0.0578931525902245
"T","501010110",1990,"COLEMAN NFH",48656,0,3816,0,52472,0.92727549931392
"T","H50402",1985,"COLEMAN NFH",24933,0,587,0,25520,0.976998432601881
"T","501011206",1994,"COLEMAN NFH",52653,0,0,0,52653,1
"T","66037",1982,"COLEMAN NFH",43508,0,5159,0,48667,0.893993876754269
"T","66018",1980,"COLEMAN NFH",46548,0,5460,0,52008,0.895016151361329
"T","66042",1983,"COLEMAN NFH",50742,0,1088,0,51830,0.979008296353463
"T","66020",1980,"COLEMAN NFH",43059,0,8141,0,51200,0.84099609375
"T","66021",1980,"COLEMAN NFH",43562,0,8236,0,51798,0.840997721919765
"T","66031",1981,"COLEMAN NFH",44540,0,5675,0,50215,0.886985960370407
"T","66032",1982,"COLEMAN NFH",45986,0,3835,0,49821,0.923024427450272
"T","66033",1982,"COLEMAN NFH",46099,0,4063,0,50162,0.919002432119931
"T","66039",1983,"COLEMAN NFH",49351,0,1007,0,50358,0.980003177250884
"T","66030",1981,"COLEMAN NFH",44735,0,5699,0,50434,0.887000832771543
"T","66038",1983,"COLEMAN NFH",49400,0,1008,0,50408,0.980003174099349
"T","501021507",1999,"COLEMAN NFH",34553,0,1615,409347,445515,0.0775574335319798
"T","501020402",1996,"COLEMAN NFH",34416,0,1811,0,36227,0.950009661302344
"T","H60107",1980,"COLEMAN NFH",45796,0,5088,0,50884,0.900007861017216
"T","H60204",1981,"COLEMAN NFH",43849,0,6150,0,49999,0.876997539950799
"T","H60103",1980,"COLEMAN NFH",45193,0,7480,0,52673,0.857991760484499
"T","H60302",1981,"COLEMAN NFH",41470,0,10693,0,52163,0.795007955830761
"T","66025",1981,"COLEMAN NFH",47254,0,4446,0,51700,0.914003868471954
"T","66026",1981,"COLEMAN NFH",42964,0,7287,0,50251,0.854987960438598
"T","501020512",1997,"COLEMAN NFH",27628,0,419542,2080,449250,0.0614980523094046
"T","501021404",1999,"COLEMAN NFH",34628,541,902,413732,449803,0.0769848133516228
"T","66016",1980,"COLEMAN NFH",86213,0,15513,0,101726,0.847502113520634
"T","66043",1983,"COLEMAN NFH",49479,0,1061,0,50540,0.979006727344678
"T","501011515",1999,"COLEMAN NFH",46216,0,2690,0,48906,0.944996523943892
"T","501020102",1999,"COLEMAN NFH",47168,0,963,0,48131,0.979992104880431
"T","66027",1981,"COLEMAN NFH",41738,0,7078,0,48816,0.855006555227794
"T","66036",1982,"COLEMAN NFH",44382,0,5152,0,49534,0.895990632696734
"T","66218",1981,"COLEMAN NFH",89780,0,11896,0,101676,0.883000904834966
"T","H60502",1983,"COLEMAN NFH",46767,0,3901,0,50668,0.92300860503671
"T","H60603",1984,"COLEMAN NFH",50550,0,1350,0,51900,0.973988439306358
"T","H60704",1985,"COLEMAN NFH",52748,0,1464,0,54212,0.972994908876264
"T","H60406",1983,"COLEMAN NFH",45465,0,5108,0,50573,0.898997488778597
"T","H60507",1984,"COLEMAN NFH",49183,0,6517,0,55700,0.882998204667864
"T","H60702",1985,"COLEMAN NFH",52635,0,1184,0,53819,0.978000334454375
"T","56238",2017,"COLEMAN NFH",114566,0,345167,0,459733,0.249201166764187
"T","56246",2017,"COLEMAN NFH",71606,0,216283,0,287889,0.248727808287222
"T","56241",2017,"COLEMAN NFH",78830,0,237972,0,316802,0.248830499807451
"T","56249",2017,"COLEMAN NFH",58894,0,178038,0,236932,0.248569209731062
"T","56245",2017,"COLEMAN NFH",77645,0,234297,0,311942,0.248908450929981
"T","56243",2017,"COLEMAN NFH",94803,0,285771,0,380574,0.249105298838071
"T","56240",2017,"COLEMAN NFH",102013,0,307491,0,409504,0.24911356177229
"T","56248",2017,"COLEMAN NFH",72941,0,220257,0,293198,0.248777276789064
"T","56244",2017,"COLEMAN NFH",79660,0,240279,0,319939,0.248984962758526
"T","53999",2017,"COLEMAN NFH",15497,0,47739,0,63236,0.245066101587703
"T","56304",2018,"COLEMAN NFH",117345,0,1361,357982,476688,0.246167304400362
"T","56306",2018,"COLEMAN NFH",118384,0,311,357561,476256,0.248572196465766
"T","56305",2018,"COLEMAN NFH",104807,0,1932,321755,428494,0.24459385662343
"T","56303",2018,"COLEMAN NFH",96902,0,1309,296415,394626,0.245554018234987
"T","56290",2018,"COLEMAN NFH",110346,0,581,334296,445223,0.247844338679718
"T","56288",2018,"COLEMAN NFH",122098,0,367975,0,490073,0.249142474692546
"T","56295",2018,"COLEMAN NFH",114146,0,490,345851,460487,0.247881047673441
"T","56296",2018,"COLEMAN NFH",125802,0,295,379870,505967,0.248636768801127
"T","56292",2018,"COLEMAN NFH",116795,0,352014,0,468809,0.249131309339198
"T","56287",2018,"COLEMAN NFH",112620,0,300,339255,452175,0.249062862829657
"T","56297",2018,"COLEMAN NFH",115450,0,1461,352336,469247,0.246032473302973
"T","56293",2018,"COLEMAN NFH",112495,0,337814,0,450309,0.249817347643507
"T","56289",2018,"COLEMAN NFH",113072,0,586,341680,455338,0.24832541979804
"T","56291",2018,"COLEMAN NFH",93127,0,237,280420,373784,0.249146565931126
"T","56299",2018,"COLEMAN NFH",123704,0,372681,0,496385,0.249209786758262
"T","56242",2017,"COLEMAN NFH",87790,0,264771,0,352561,0.249006554894047
"T","56237",2017,"COLEMAN NFH",115967,0,349469,0,465436,0.249157778942755
"T","56235",2017,"COLEMAN NFH",106255,0,319021,0,425276,0.24984950949501
"T","56247",2017,"COLEMAN NFH",81222,0,244999,0,326221,0.248978453257148
"T","56236",2017,"COLEMAN NFH",113145,0,339786,0,452931,0.249806261880949
"T","56239",2017,"COLEMAN NFH",98678,0,297400,0,396078,0.249137796090669
"T","56298",2018,"COLEMAN NFH",21489,0,135,65155,86779,0.247629034674288
"T","54304",1984,"COLEMAN NFH",9756,0,189,0,9945,0.980995475113122
"T","601110209",1991,"COLEMAN NFH",21111,0,3239,0,24350,0.866981519507187
"T","H50404",1985,"COLEMAN NFH",26900,0,354,0,27254,0.987011080942247
"T","50947",1984,"COLEMAN NFH",21871,0,424,0,22295,0.980982283023099
"T","66011",1976,"COLEMAN NFH",198762,0,42747,0,241509,0.823000385078817
"T","51840",1986,"COLEMAN NFH",51807,0,523,0,52330,0.990005732849226
"T","H60602",1984,"COLEMAN NFH",51145,0,1855,0,53000,0.965
"T","H60407",1983,"COLEMAN NFH",42165,0,8514,0,50679,0.832001420706802
"T","66010",1976,"COLEMAN NFH",190978,0,18888,0,209866,0.909999714103285
"T","H60601",1984,"COLEMAN NFH",50052,0,2798,0,52850,0.947057710501419
"T","H60501",1983,"COLEMAN NFH",45036,0,6729,0,51765,0.870008693132425
"T","52040",1988,"COLEMAN NFH",39379,0,1555,0,40934,0.962012019348219
"T","H50205",1979,"COLEMAN NFH",20788,0,4185,0,24973,0.832419012533536
"T","H50204",1979,"COLEMAN NFH",21939,0,4493,0,26432,0.830016646489104
"T","55691",2013,"COLEMAN NFH",103991,0,254,313195,417440,0.249116040628593
"T","55692",2013,"COLEMAN NFH",108312,0,270,326158,434740,0.24914201591756
"T","55693",2013,"COLEMAN NFH",106227,0,318892,0,425119,0.249875917096154
"T","55794",2014,"COLEMAN NFH",107111,0,321584,0,428695,0.24985362553797
"T","55798",2014,"COLEMAN NFH",114111,0,343839,0,457950,0.249177857844743
"T","55805",2014,"COLEMAN NFH",108834,0,1216,331824,441874,0.246300981727823
"T","55806",2014,"COLEMAN NFH",100607,256,302962,0,403825,0.249135145174271
"T","55807",2014,"COLEMAN NFH",106747,321,321,322446,429835,0.248344132050671
"T","55810",2014,"COLEMAN NFH",103338,518,259,314687,418802,0.246746672651993
"T","55811",2014,"COLEMAN NFH",99921,258,515,302374,403068,0.247901098573938
"T","55809",2014,"COLEMAN NFH",103877,0,550,313591,418018,0.248498868469779
"T","55808",2014,"COLEMAN NFH",101499,783,261,307951,410494,0.247260617694778
"T","55781",2014,"COLEMAN NFH",103366,0,310332,0,413698,0.249858592499843
"T","55782",2014,"COLEMAN NFH",103407,0,310363,0,413770,0.249914203543031
"T","55783",2014,"COLEMAN NFH",111208,0,333948,0,445156,0.249818041315853
"T","55784",2014,"COLEMAN NFH",105129,0,315643,0,420772,0.249847898624433
"T","55785",2014,"COLEMAN NFH",111112,0,333666,0,444778,0.249814514207088
"T","55786",2014,"COLEMAN NFH",86765,0,260551,0,347316,0.249815729767704
"T","55787",2014,"COLEMAN NFH",114397,288,344419,0,459104,0.249174478985154
"T","55788",2014,"COLEMAN NFH",96479,0,290745,0,387224,0.249155527549945
"T","56411",2019,"COLEMAN NFH",105224,0,257,317875,423356,0.248547321875679
"T","56418",2019,"COLEMAN NFH",106233,0,282,320877,427392,0.248561039982031
"T","501021513",2003,"COLEMAN NFH",47053,0,3063,0,50116,0.938881794237369
"N","!07199400074",1993,"COLEMAN NFH",0,0,932256,0,932256,0
"N","!07199400075",1993,"COLEMAN NFH",0,0,1294341,0,1294341,0
"N","!07199400076",1993,"COLEMAN NFH",0,0,1257406,0,1257406,0
"T","56401",2019,"COLEMAN NFH",111949,0,1682,341634,455265,0.245898542607053
"T","56402",2019,"COLEMAN NFH",108739,0,327801,0,436540,0.249092866633069
"T","56403",2019,"COLEMAN NFH",108897,0,327162,0,436059,0.249729967733724
"T","56404",2019,"COLEMAN NFH",116517,0,351496,0,468013,0.248961033133695
"T","56405",2019,"COLEMAN NFH",108050,0,324677,0,432727,0.249695535522396
"T","56406",2019,"COLEMAN NFH",111757,0,365,338248,450370,0.248144858671759
"T","56407",2019,"COLEMAN NFH",113734,0,815,345373,459922,0.247289757828501
"T","56408",2019,"COLEMAN NFH",64144,0,194001,0,258145,0.248480505142459
"T","56409",2019,"COLEMAN NFH",116142,0,350131,0,466273,0.249085835980209
"T","56410",2019,"COLEMAN NFH",94931,0,286341,0,381272,0.248984976604629
"T","56412",2019,"COLEMAN NFH",96421,0,290655,0,387076,0.249100951751077
"T","56413",2019,"COLEMAN NFH",115373,0,1672,352773,469818,0.245569560978932
"T","56419",2019,"COLEMAN NFH",115034,0,623,350539,466196,0.246750293867815
"T","56420",2019,"COLEMAN NFH",89065,0,928,271287,361280,0.24652624003543
"T","56421",2019,"COLEMAN NFH",119307,0,359400,0,478707,0.249227606865995
"T","56422",2019,"COLEMAN NFH",92659,0,279427,0,372086,0.249025762861274
"T","56423",2019,"COLEMAN NFH",120916,0,364269,0,485185,0.249216278326824
"T","56424",2019,"COLEMAN NFH",100146,0,286,302638,403070,0.248458084203736
"T","56426",2019,"COLEMAN NFH",112983,0,845,342964,456792,0.247340146062103
"T","56425",2019,"COLEMAN NFH",100786,0,2073,310008,412867,0.244112510808565
"T","56427",2019,"COLEMAN NFH",112134,0,281,338690,451105,0.248576273816517
"T","56428",2019,"COLEMAN NFH",110985,0,334442,0,445427,0.249165407575203
"T","56429",2019,"COLEMAN NFH",90877,461,923,0,92261,0.984999078700643
"T","56430",2019,"COLEMAN NFH",93129,0,468,0,93597,0.994999839738453
"T","56431",2019,"COLEMAN NFH",95333,0,479,0,95812,0.99500062622636
"T","56432",2019,"COLEMAN NFH",92417,0,1407,0,93824,0.985003836971351
"T","55450",2019,"COLEMAN NFH",8463,0,25497,0,33960,0.249204946996466
"T","56415",2019,"COLEMAN NFH",97754,0,291,295668,393713,0.248287458123049
"T","56416",2019,"COLEMAN NFH",110992,0,1203,338221,450416,0.246421086284679
"T","56417",2019,"COLEMAN NFH",103710,0,568,314139,418417,0.247862778042001
"T","56414",2019,"COLEMAN NFH",107999,0,560,327442,436001,0.247703560312935
"N","!07199800078",1997,"COLEMAN NFH",0,0,8203920,0,8203920,0
"T","501020107",2004,"COLEMAN NFH",48360,0,1527,0,49887,0.969390823260569
"T","501020108",2004,"COLEMAN NFH",49512,0,527,0,50039,0.989468214792462
"T","501020109",2004,"COLEMAN NFH",25242,0,156,0,25398,0.993857784077486
"N","!07199900205",1998,"COLEMAN NFH",0,0,3205,0,3205,0
"N","!07199900206",1998,"COLEMAN NFH",0,0,3371,0,3371,0
"N","!07199900207",1998,"COLEMAN NFH",0,0,3093,0,3093,0
"T","501040704",2005,"COLEMAN NFH",23224,318,954,0,24496,0.948073154800784
"T","501040705",2005,"COLEMAN NFH",24668,252,252,0,25172,0.979977753058954
"T","501040702",2005,"COLEMAN NFH",23674,125,376,0,24175,0.979276111685626
"T","54894",2008,"COLEMAN NFH",114907,0,344836,0,459743,0.249937465062002
"T","54895",2008,"COLEMAN NFH",124228,0,372882,0,497110,0.24990042445334
"T","54896",2008,"COLEMAN NFH",112556,0,338978,0,451534,0.249274694707375
"T","54897",2008,"COLEMAN NFH",125703,0,377299,0,503002,0.249905566975877
"T","54898",2008,"COLEMAN NFH",112230,0,337961,0,450191,0.249294188466673
"T","54899",2008,"COLEMAN NFH",111839,0,336830,0,448669,0.249268391620549
"T","54891",2008,"COLEMAN NFH",117384,0,352405,0,469789,0.249865365089434
"T","56058",2016,"COLEMAN NFH",95911,195,584,291963,388653,0.246777974182626
"T","56060",2016,"COLEMAN NFH",101149,551,307689,0,409389,0.247073077195528
"T","56063",2016,"COLEMAN NFH",103195,0,262,311942,415399,0.248423804583064
"T","56064",2016,"COLEMAN NFH",118521,0,357331,0,475852,0.249071139766146
"T","56068",2016,"COLEMAN NFH",110129,0,553,333441,444123,0.247969594008867
"T","56072",2016,"COLEMAN NFH",107992,0,325344,0,433336,0.249210774087544
"T","56073",2016,"COLEMAN NFH",107883,0,272,325833,433988,0.248585214337724
"T","56077",2016,"COLEMAN NFH",116071,0,349613,0,465684,0.249248417381744
"T","56079",2016,"COLEMAN NFH",112402,0,338608,0,451010,0.249222855369061
"T","56080",2016,"COLEMAN NFH",100531,0,303073,0,403604,0.249083259828941
"T","56081",2016,"COLEMAN NFH",115292,0,302,348117,463711,0.248628995214692
"T","56082",2016,"COLEMAN NFH",96982,0,948,295240,393170,0.246666836228603
"T","56065",2016,"COLEMAN NFH",112757,282,339375,0,452414,0.249234108581963
"T","56066",2016,"COLEMAN NFH",100368,0,301263,0,401631,0.249901028556063
"T","56083",2016,"COLEMAN NFH",109423,0,1389,333781,444593,0.246119484562285
"T","56075",2016,"COLEMAN NFH",112050,0,581,339229,451860,0.247975036515735
"T","56084",2016,"COLEMAN NFH",120432,0,362785,0,483217,0.249229642169046
"T","56085",2016,"COLEMAN NFH",111545,0,336023,0,447568,0.249224698816716
"N","!07200300041",2002,"COLEMAN NFH",0,0,5214104,0,5214104,0
"N","!07199100217",1990,"COLEMAN NFH",0,0,4464809,0,4464809,0
"N","!07198700097",1986,"COLEMAN NFH",0,0,18100,0,18100,0
"N","!07199100221",1990,"COLEMAN NFH",0,0,5049448,0,5049448,0
"N","!07198500147",1984,"COLEMAN NFH",0,0,4254270,0,4254270,0
"N","!07198600113",1985,"COLEMAN NFH",0,0,608140,0,608140,0
"T","55959",2015,"COLEMAN NFH",122928,0,371039,0,493967,0.248858729429294
"T","55956",2015,"COLEMAN NFH",114271,0,343339,0,457610,0.249712637398658
"T","55957",2015,"COLEMAN NFH",95513,0,287420,0,382933,0.249424834109361
"T","55962",2015,"COLEMAN NFH",93418,0,280381,0,373799,0.249915061303
"T","501020403",1996,"COLEMAN NFH",34802,0,478642,1450,514894,0.0675906108830167
"T","501020304",1996,"COLEMAN NFH",31413,0,389986,3490,424889,0.0739322505407295
"T","501020312",1996,"COLEMAN NFH",35045,0,399942,1460,436447,0.0802961184290418
"T","50883",2001,"COLEMAN NFH",77728,0,627,362301,440656,0.176391561671689
"T","501040304",2001,"COLEMAN NFH",49714,251,251,0,50216,0.990003186235463
"T","501040202",2001,"COLEMAN NFH",71246,880,1173,359374,432673,0.164664769930178
"N","!07200000123",1999,"COLEMAN NFH",0,0,9932,0,9932,0
"N","!07197500127",1974,"COLEMAN NFH",0,0,237650,0,237650,0
"N","!07198200029",1982,"COLEMAN NFH",0,0,219040,0,219040,0
"N","!07198300052",1982,"COLEMAN NFH",0,0,805420,0,805420,0
"N","!07198300053",1982,"COLEMAN NFH",0,0,1136090,0,1136090,0
"N","!07198300054",1982,"COLEMAN NFH",0,0,3114000,0,3114000,0
"N","!07198300063",1982,"COLEMAN NFH",0,0,2101920,0,2101920,0
"N","!07198500155",1984,"COLEMAN NFH",0,0,204660,0,204660,0
"N","!07198500156",1984,"COLEMAN NFH",0,0,656640,0,656640,0
"N","!07198500162",1984,"COLEMAN NFH",0,0,2007000,0,2007000,0
"N","!07197600128",1975,"COLEMAN NFH",0,0,10950,0,10950,0
"N","!07199500160",1994,"COLEMAN NFH",0,0,85792,0,85792,0
"N","!07199500161",1994,"COLEMAN NFH",0,0,10832533,0,10832533,0
"N","!07197900039",1978,"COLEMAN NFH",0,0,3405975,0,3405975,0
"T","54392",2007,"COLEMAN NFH",91718,0,137,275880,367735,0.249413300338559
"T","54393",2007,"COLEMAN NFH",108921,0,327166,0,436087,0.249768968118747
"T","54394",2007,"COLEMAN NFH",113845,0,341838,0,455683,0.249833766017165
"T","H50304",1979,"COLEMAN NFH",22829,0,2296,231,25356,0.900339170216122
"T","H50302",1979,"COLEMAN NFH",22560,0,2279,228,25067,0.899988032074042
"T","50570",2000,"COLEMAN NFH",64981,0,373224,0,438205,0.148289042799603
"T","50566",2000,"COLEMAN NFH",64479,0,651,362556,427686,0.150762475273916
"T","501030508",2000,"COLEMAN NFH",59872,0,4507,364700,429079,0.139536076107197
"T","501030509",2000,"COLEMAN NFH",58197,0,6466,414813,479476,0.12137625240888
"T","501030502",2000,"COLEMAN NFH",44594,0,4955,0,49549,0.899997981795798
"T","501030503",2000,"COLEMAN NFH",57896,0,6433,372181,436510,0.132633845730911
"T","54466",2007,"COLEMAN NFH",222908,0,669119,0,892027,0.249889297072846
"T","54467",2007,"COLEMAN NFH",224687,0,284,675495,900466,0.249523024744965
"T","501020408",1998,"COLEMAN NFH",12486,0,797,0,13283,0.939998494316043
"T","501011514",1999,"COLEMAN NFH",48798,246,246,0,49290,0.990018259281802
"T","501020409",1998,"COLEMAN NFH",13367,0,853,0,14220,0.940014064697609
"T","501021311",1999,"COLEMAN NFH",6383,0,480,0,6863,0.930059740638205
"T","B50203",1991,"COLEMAN NFH",53276,0,5920,0,59196,0.899993242786675
"T","501020411",1998,"COLEMAN NFH",301,0,19,0,320,0.940625
"T","501020609",1997,"COLEMAN NFH",31952,0,403860,5202,441014,0.0724512147006671
"T","52812",1991,"COLEMAN NFH",54433,0,4160,0,58593,0.929001757889168
"T","601141101",1992,"COLEMAN NFH",30715,0,950,0,31665,0.969998420969525
"T","501021112",1998,"COLEMAN NFH",35099,546,727,443891,480263,0.0730828733423145
"T","501021115",1998,"COLEMAN NFH",35530,366,733,446746,483375,0.0735040082751487
"T","501021315",1999,"COLEMAN NFH",32817,544,2901,413636,449898,0.0729432004587707
"T","501021313",1999,"COLEMAN NFH",33820,180,1979,437688,473667,0.0714003719912935
"T","501020607",1997,"COLEMAN NFH",33392,0,406703,4127,444222,0.0751696223960092
"T","H50307",1984,"COLEMAN NFH",29136,0,625,0,29761,0.978999361580592
"T","501020608",1997,"COLEMAN NFH",32007,0,403831,5210,441048,0.0725703324808184
"T","52055",1989,"COLEMAN NFH",51069,0,1852,0,52921,0.965004440581244
"T","501021509",1999,"COLEMAN NFH",35908,0,771,177517,214196,0.167640852303498
"T","501021101",1998,"COLEMAN NFH",32136,2401,2401,407109,444047,0.072370717514137
"T","56318",2018,"COLEMAN NFH",89067,0,448,0,89515,0.99499525219237
"T","56294",2018,"COLEMAN NFH",95128,0,240,286676,382044,0.248997497670425
"T","56307",2018,"COLEMAN NFH",115239,0,347170,0,462409,0.249214440030363
"T","56308",2018,"COLEMAN NFH",121632,0,306,367356,489294,0.248586739261058
"T","56309",2018,"COLEMAN NFH",116004,0,350703,0,466707,0.248558517442421
"T","56310",2018,"COLEMAN NFH",118753,0,357894,0,476647,0.249142447135931
"T","56311",2018,"COLEMAN NFH",115461,0,347770,0,463231,0.249251453378552
"T","56312",2018,"COLEMAN NFH",125835,0,364,380004,506203,0.248586041568304
"T","56314",2018,"COLEMAN NFH",123252,0,273,372108,495633,0.24867593562172
"T","56313",2018,"COLEMAN NFH",103340,0,311447,0,414787,0.249139920007136
"T","56315",2018,"COLEMAN NFH",116588,0,296,353212,470096,0.248008917327525
"T","56316",2018,"COLEMAN NFH",116742,0,616,353520,470878,0.247924090741126
"T","56317",2018,"COLEMAN NFH",113833,0,342859,0,456692,0.249255515752411
"T","56319",2018,"COLEMAN NFH",84396,0,0,0,84396,1
"T","56320",2018,"COLEMAN NFH",87053,0,879,0,87932,0.990003639175727
"T","56321",2018,"COLEMAN NFH",87599,0,440,0,88039,0.995002214927475
"N","!07197500123",1974,"COLEMAN NFH",0,0,349815,0,349815,0
"N","!07197500124",1974,"COLEMAN NFH",0,0,1526375,0,1526375,0
"N","!07197500125",1974,"COLEMAN NFH",0,0,1689792,0,1689792,0
"N","!07198600106",1985,"COLEMAN NFH",0,0,527810,0,527810,0
"N","!07200600402",2005,"COLEMAN NFH",0,0,4193388,0,4193388,0
"T","501040706",2005,"COLEMAN NFH",24256,369,0,0,24625,0.985015228426396
"N","!07200600501",2005,"COLEMAN NFH",0,0,2363701,0,2363701,0
"T","53865",2006,"COLEMAN NFH",41770,0,351,170159,212280,0.196768419069154
"T","54881",2008,"COLEMAN NFH",106531,0,319908,0,426439,0.249815331149355
"T","55378",2010,"COLEMAN NFH",113686,0,341215,0,454901,0.249913717490179
"T","55379",2010,"COLEMAN NFH",106750,0,320379,0,427129,0.249924495878294
"T","55380",2010,"COLEMAN NFH",109892,0,329972,0,439864,0.249831766182275
"T","55514",2011,"COLEMAN NFH",84243,0,252923,0,337166,0.249856153941975
"N","!07199400080",1993,"COLEMAN NFH",0,0,34775,0,34775,0
"N","!07199400081",1993,"COLEMAN NFH",0,0,11959696,0,11959696,0
"N","!07199100213",1990,"COLEMAN NFH",0,0,550045,0,550045,0
"N","!07199100214",1990,"COLEMAN NFH",0,0,680214,0,680214,0
"T","501030602",2000,"COLEMAN NFH",61071,0,3554,359928,424553,0.143847764590051
"N","!07197700129",1976,"COLEMAN NFH",0,0,802070,0,802070,0
"N","!07197700130",1976,"COLEMAN NFH",0,0,302373,0,302373,0
"N","!07197700131",1976,"COLEMAN NFH",0,0,315442,0,315442,0
"T","55789",2014,"COLEMAN NFH",109417,0,328546,0,437963,0.249831606779568
"T","55790",2014,"COLEMAN NFH",106614,0,320240,0,426854,0.249766899220811
"T","55791",2014,"COLEMAN NFH",106009,0,318235,0,424244,0.249877429026692
"T","55792",2014,"COLEMAN NFH",103126,0,309526,0,412652,0.249910336070103
"T","55793",2014,"COLEMAN NFH",111213,0,333823,0,445036,0.249896637575387
"N","!07199400077",1993,"COLEMAN NFH",0,0,918666,0,918666,0
"N","!07197600138",1975,"COLEMAN NFH",0,0,7573,0,7573,0
"N","!07197600139",1975,"COLEMAN NFH",0,0,306883,0,306883,0
"N","!07197600140",1975,"COLEMAN NFH",0,0,35267,0,35267,0
"N","!07197600144",1975,"COLEMAN NFH",0,0,45962,0,45962,0
"N","!07197600145",1975,"COLEMAN NFH",0,0,39396,0,39396,0
"N","!07197600146",1975,"COLEMAN NFH",0,0,126904,0,126904,0
"N","!07197600147",1975,"COLEMAN NFH",0,0,285727,0,285727,0
"N","!07197600148",1975,"COLEMAN NFH",0,0,88028,0,88028,0
"N","!07197600149",1975,"COLEMAN NFH",0,0,284158,0,284158,0
"N","!07197600150",1975,"COLEMAN NFH",0,0,27826,0,27826,0
"N","!07197600151",1975,"COLEMAN NFH",0,0,938300,0,938300,0
"N","!07197600152",1975,"COLEMAN NFH",0,0,106392,0,106392,0
"N","!07197700123",1976,"COLEMAN NFH",0,0,4942885,0,4942885,0
"N","!07197700124",1976,"COLEMAN NFH",0,0,353053,0,353053,0
"N","!07197700125",1977,"COLEMAN NFH",0,0,25300,0,25300,0
"N","!07199100209",1990,"COLEMAN NFH",0,0,200018,0,200018,0
"N","!07199100210",1990,"COLEMAN NFH",0,0,672559,0,672559,0
"N","!07198200031",1981,"COLEMAN NFH",0,0,250000,0,250000,0
"N","!07198300064",1982,"COLEMAN NFH",0,0,545720,0,545720,0
"N","!07198300065",1982,"COLEMAN NFH",0,0,1173350,0,1173350,0
"N","!07198300066",1982,"COLEMAN NFH",0,0,1160550,0,1160550,0
"N","!07198200030",1981,"COLEMAN NFH",0,0,7839156,0,7839156,0
"N","!07199100216",1990,"COLEMAN NFH",0,0,666834,0,666834,0
"T","501021514",2003,"COLEMAN NFH",48808,0,1444,0,50252,0.971264825280586
"N","!07199100218",1990,"COLEMAN NFH",0,0,2390322,0,2390322,0
"N","!07199100219",1990,"COLEMAN NFH",0,0,6349775,0,6349775,0
"N","!07199100220",1990,"COLEMAN NFH",0,0,901820,0,901820,0
"N","!07199100222",1990,"COLEMAN NFH",0,0,218638,0,218638,0
"N","!07198500145",1984,"COLEMAN NFH",0,0,3760,0,3760,0
"N","!07200300043",2002,"COLEMAN NFH",0,0,3349443,0,3349443,0
"N","!07198500148",1984,"COLEMAN NFH",0,0,5820,0,5820,0
"T","501020106",2002,"COLEMAN NFH",50147,0,0,0,50147,1
"T","501020105",2002,"COLEMAN NFH",49848,0,250,0,50098,0.995009780829574
"T","501020104",2002,"COLEMAN NFH",49896,0,504,0,50400,0.99
"T","501020103",2002,"COLEMAN NFH",47176,0,2760,251,50187,0.940004383605316
"T","55952",2015,"COLEMAN NFH",101339,0,304400,0,405739,0.249764010854268
"T","52489",2015,"COLEMAN NFH",12315,0,36945,0,49260,0.25
"T","55953",2015,"COLEMAN NFH",104024,0,312366,0,416390,0.249823482792574
"T","55971",2015,"COLEMAN NFH",116386,308,350512,0,467206,0.249110670667757
"T","55972",2015,"COLEMAN NFH",97727,0,293526,0,391253,0.249779554405973
"T","55973",2015,"COLEMAN NFH",116636,0,350294,0,466930,0.249793330906132
"T","55974",2015,"COLEMAN NFH",94858,0,284738,0,379596,0.249891990431933
"T","55970",2015,"COLEMAN NFH",99060,0,297520,0,396580,0.249785667456755
"T","55978",2015,"COLEMAN NFH",117001,0,351296,0,468297,0.249843582171144
"T","55979",2015,"COLEMAN NFH",111343,0,335326,0,446669,0.249274070956346
"T","55976",2015,"COLEMAN NFH",115582,0,347038,0,462620,0.249842203104059
"T","55975",2015,"COLEMAN NFH",109359,367,734,331687,442147,0.247336293133279
"T","55977",2015,"COLEMAN NFH",112920,0,339137,0,452057,0.249791508592943
"T","55960",2015,"COLEMAN NFH",90361,0,271307,0,361668,0.249845161861154
"T","55961",2015,"COLEMAN NFH",111609,0,335060,0,446669,0.249869590233484
"N","!07198600115",1985,"COLEMAN NFH",0,0,3327676,0,3327676,0
"T","55954",2015,"COLEMAN NFH",100555,0,857,304485,405897,0.24773526288689
"T","55955",2015,"COLEMAN NFH",116707,0,350876,0,467583,0.249596328352399
"T","55958",2015,"COLEMAN NFH",107719,0,321612,0,429331,0.25089965551055
"T","55963",2015,"COLEMAN NFH",116075,0,301,349303,465679,0.249259683172314
"T","55964",2015,"COLEMAN NFH",91715,232,232,276808,368987,0.2485588923187
"T","55969",2015,"COLEMAN NFH",119619,0,330,360004,479953,0.249230653834855
"T","55967",2015,"COLEMAN NFH",96831,0,291741,0,388572,0.249197060004324
"T","55968",2015,"COLEMAN NFH",118778,0,316,357511,476605,0.24921685672622
"T","55965",2015,"COLEMAN NFH",116073,0,348445,0,464518,0.24987836854546
"T","55966",2015,"COLEMAN NFH",113019,0,339324,0,452343,0.249852434988493
"T","501020115",1995,"COLEMAN NFH",308443,0,3787025,12184,4107652,0.0750898566869832
"T","501020405",1996,"COLEMAN NFH",34298,0,594206,1805,630309,0.0544145807849801
"T","501020310",1996,"COLEMAN NFH",31777,0,352216,649,384642,0.082614483077771
"T","501020308",1996,"COLEMAN NFH",35473,0,401405,1097,437975,0.0809932073748502
"T","501020301",1996,"COLEMAN NFH",33195,0,402106,3283,438584,0.0756867555587983
"T","501020314",1996,"COLEMAN NFH",34681,0,408878,1073,444632,0.0779993342809334
"T","501020215",1996,"COLEMAN NFH",34936,0,404040,1456,440432,0.0793221201002652
"N","!07198700098",1986,"COLEMAN NFH",0,0,108752,0,108752,0
"N","!07198000043",1979,"COLEMAN NFH",0,0,3515605,0,3515605,0
"T","501020212",1996,"COLEMAN NFH",32813,0,407442,2853,443108,0.0740519241358766
"T","501020211",1996,"COLEMAN NFH",30962,0,397914,4626,433502,0.0714229692135215
"T","501020309",1996,"COLEMAN NFH",33626,0,388537,1770,423933,0.0793191376939281
"T","501020401",1996,"COLEMAN NFH",34417,0,441308,1811,477536,0.0720720532064598
"T","501020306",1996,"COLEMAN NFH",34492,0,399715,1815,436022,0.0791061001509098
"T","501020214",1996,"COLEMAN NFH",32178,0,402028,4388,438594,0.0733662567203382
"T","501020311",1996,"COLEMAN NFH",35198,0,400433,718,436349,0.0806647889647965
"T","501020201",1995,"COLEMAN NFH",268960,0,3868300,7463,4144723,0.0648921532271276
"T","501020210",1996,"COLEMAN NFH",33307,0,401098,2896,437301,0.0761649298766753
"T","501020209",1996,"COLEMAN NFH",32018,0,399662,4366,436046,0.0734280328222252
"T","501020303",1996,"COLEMAN NFH",31826,0,368025,1675,401526,0.0792626131309056
"N","!07198000044",1979,"COLEMAN NFH",0,0,7101883,0,7101883,0
"N","!07198400086",1983,"COLEMAN NFH",0,0,150000,0,150000,0
"N","!07198400088",1983,"COLEMAN NFH",0,0,3000,0,3000,0
"T","50884",2001,"COLEMAN NFH",79138,0,318,347614,427070,0.18530451682394
"T","50885",2001,"COLEMAN NFH",78259,0,299172,0,377431,0.207346508368417
"T","50886",2001,"COLEMAN NFH",78641,0,222159,0,300800,0.261439494680851
"T","50887",2001,"COLEMAN NFH",78035,315,329038,0,407388,0.191549579270867
"T","54398",2007,"COLEMAN NFH",109295,0,127,328645,438067,0.249493798893777
"T","501040906",2007,"COLEMAN NFH",23733,0,989,0,24722,0.959995146023784
"T","501040302",2001,"COLEMAN NFH",50205,252,0,0,50457,0.995005648373863
"T","501040301",2001,"COLEMAN NFH",48956,1004,251,0,50211,0.975005476887535
"T","501040209",2001,"COLEMAN NFH",71725,0,2371,427789,501885,0.142911224682945
"T","501040208",2001,"COLEMAN NFH",73443,0,892,326857,401192,0.183061975313566
"T","501040207",2001,"COLEMAN NFH",72025,293,878,328791,401987,0.179172460800971
"T","501040206",2001,"COLEMAN NFH",72306,0,986,373532,446824,0.16182210445276
"T","501040205",2001,"COLEMAN NFH",71501,293,1465,396319,469578,0.152266503115563
"T","501040303",2001,"COLEMAN NFH",49373,251,501,0,50125,0.984997506234414
"T","501040201",2001,"COLEMAN NFH",72064,0,875,415325,488264,0.147592286140285
"T","501040106",2001,"COLEMAN NFH",70928,377,1886,303979,377170,0.188053132539704
"T","50875",2001,"COLEMAN NFH",78030,684,308226,0,386940,0.201659171964646
"T","50876",2001,"COLEMAN NFH",77386,0,315,373572,451273,0.171483780328094
"T","50877",2001,"COLEMAN NFH",77992,0,314,380222,458528,0.170092120873753
"T","50878",2001,"COLEMAN NFH",77223,0,633,396932,474788,0.162647328913115
"T","50881",2001,"COLEMAN NFH",78898,0,317,356862,436077,0.180926762934069
"T","501040105",2001,"COLEMAN NFH",70307,355,1420,226898,298980,0.235156197738979
"T","501040107",2001,"COLEMAN NFH",73430,0,333965,0,407395,0.180242761938659
"T","501040901",2007,"COLEMAN NFH",23557,0,359,0,23916,0.984989128616826
"T","501040902",2007,"COLEMAN NFH",25421,0,128,0,25549,0.994990019178833
"T","501040903",2007,"COLEMAN NFH",24687,126,378,0,25191,0.979992854590925
"T","501040904",2007,"COLEMAN NFH",25734,129,0,0,25863,0.995012179561536
"N","!07199900063",1998,"COLEMAN NFH",0,0,755073,0,755073,0
"N","!07199900164",1999,"COLEMAN NFH",0,0,3000,0,3000,0
"N","!07199900165",1999,"COLEMAN NFH",0,0,3000,0,3000,0
"N","!07199900166",1999,"COLEMAN NFH",0,0,3000,0,3000,0
"N","!07198700090",1986,"COLEMAN NFH",0,0,5312900,0,5312900,0
"N","!07198700091",1986,"COLEMAN NFH",0,0,4072260,0,4072260,0
"N","!07198700092",1986,"COLEMAN NFH",0,0,11800,0,11800,0
"N","!07198700093",1987,"COLEMAN NFH",0,0,507000,0,507000,0
"N","!07198600108",1985,"COLEMAN NFH",0,0,5388827,0,5388827,0
"N","!07197500121",1974,"COLEMAN NFH",0,0,27900,0,27900,0
"N","!07199900167",1999,"COLEMAN NFH",0,0,3000,0,3000,0
"N","!07199900168",1998,"COLEMAN NFH",0,0,3100,0,3100,0
"N","!07198000041",1978,"COLEMAN NFH",0,0,92700,0,92700,0
"N","!07198100028",1980,"COLEMAN NFH",0,0,13756080,0,13756080,0
"N","!07197500122",1974,"COLEMAN NFH",0,0,167540,0,167540,0
"N","!07197900029",1978,"COLEMAN NFH",0,0,680975,0,680975,0
"N","!07197800127",1977,"COLEMAN NFH",0,0,2171000,0,2171000,0
"N","!07199600082",1995,"COLEMAN NFH",0,0,1319814,0,1319814,0
"N","!07199600083",1995,"COLEMAN NFH",0,0,11450,0,11450,0
"N","!07199600088",1995,"COLEMAN NFH",0,0,269034,0,269034,0
"N","!07199600089",1995,"COLEMAN NFH",0,0,732473,0,732473,0
"N","!07197800128",1977,"COLEMAN NFH",0,0,744500,0,744500,0
"N","!07198000045",1979,"COLEMAN NFH",0,0,490263,0,490263,0
"N","!07198000046",1979,"COLEMAN NFH",0,0,1499900,0,1499900,0
"N","!07197800124",1977,"COLEMAN NFH",0,0,1e+05,0,1e+05,0
"N","!07197800125",1977,"COLEMAN NFH",0,0,284800,0,284800,0
"N","!07197800126",1977,"COLEMAN NFH",0,0,2851000,0,2851000,0
"N","!07199000193",1989,"COLEMAN NFH",0,0,3919302,0,3919302,0
"N","!07199000194",1989,"COLEMAN NFH",0,0,769343,0,769343,0
"N","!07199000195",1989,"COLEMAN NFH",0,0,6260590,0,6260590,0
"N","!07199000196",1989,"COLEMAN NFH",0,0,101722,0,101722,0
"N","!07199000199",1989,"COLEMAN NFH",0,0,5608310,0,5608310,0
"N","!07199300081",1992,"COLEMAN NFH",0,0,1718045,0,1718045,0
"N","!07199300082",1992,"COLEMAN NFH",0,0,1742036,0,1742036,0
"N","!07199300083",1992,"COLEMAN NFH",0,0,250,0,250,0
"N","!07199300084",1992,"COLEMAN NFH",0,0,2511443,0,2511443,0
"N","!07199300085",1992,"COLEMAN NFH",0,0,5599143,0,5599143,0
"N","!07199300090",1992,"COLEMAN NFH",0,0,8786,0,8786,0
"N","!07199600090",1995,"COLEMAN NFH",0,0,783815,0,783815,0
"N","!07199600091",1995,"COLEMAN NFH",0,0,900142,0,900142,0
"N","!07199600092",1995,"COLEMAN NFH",0,0,1018075,0,1018075,0
"N","!07199600093",1995,"COLEMAN NFH",0,0,2520268,0,2520268,0
"N","!07198300055",1982,"COLEMAN NFH",0,0,3671312,0,3671312,0
"N","!07198300056",1982,"COLEMAN NFH",0,0,1970390,0,1970390,0
"N","!07198300057",1982,"COLEMAN NFH",0,0,441178,0,441178,0
"N","!07198500153",1984,"COLEMAN NFH",0,0,199280,0,199280,0
"N","!07198500157",1984,"COLEMAN NFH",0,0,2937600,0,2937600,0
"N","!07198500158",1984,"COLEMAN NFH",0,0,1546560,0,1546560,0
"N","!07198500159",1984,"COLEMAN NFH",0,0,4141440,0,4141440,0
"N","!07198500160",1984,"COLEMAN NFH",0,0,665280,0,665280,0
"N","!07197600132",1975,"COLEMAN NFH",0,0,1683668,0,1683668,0
"N","!07198800143",1987,"COLEMAN NFH",0,0,4500719,0,4500719,0
"N","!07198800148",1987,"COLEMAN NFH",0,0,959666,0,959666,0
"N","!07198800152",1987,"COLEMAN NFH",0,0,404000,0,404000,0
"N","!07198800153",1987,"COLEMAN NFH",0,0,354910,0,354910,0
"N","!07198800154",1987,"COLEMAN NFH",0,0,321187,0,321187,0
"N","!07198800155",1987,"COLEMAN NFH",0,0,160000,0,160000,0
"N","!07198800156",1987,"COLEMAN NFH",0,0,6103200,0,6103200,0
"N","!07198800157",1987,"COLEMAN NFH",0,0,4519750,0,4519750,0
"N","!07197600133",1975,"COLEMAN NFH",0,0,1081000,0,1081000,0
"N","!07197900035",1978,"COLEMAN NFH",0,0,522575,0,522575,0
"N","!07197900038",1977,"COLEMAN NFH",0,0,360642,0,360642,0
"N","!07197600134",1975,"COLEMAN NFH",0,0,253749,0,253749,0
"N","!07199200262",1991,"COLEMAN NFH",0,0,1567486,0,1567486,0
"N","!07199200263",1991,"COLEMAN NFH",0,0,1902744,0,1902744,0
"N","!07199200264",1991,"COLEMAN NFH",0,0,1290970,0,1290970,0
"N","!07199200265",1991,"COLEMAN NFH",0,0,2336797,0,2336797,0
"N","!07199200266",1991,"COLEMAN NFH",0,0,1837222,0,1837222,0
"N","!07199200267",1991,"COLEMAN NFH",0,0,2025665,0,2025665,0
"N","!07199200268",1991,"COLEMAN NFH",0,0,10234,0,10234,0
"N","!07199200269",1991,"COLEMAN NFH",0,0,5186955,0,5186955,0
"N","!07198400077",1983,"COLEMAN NFH",0,0,1787312,0,1787312,0
"N","!07198400078",1983,"COLEMAN NFH",0,0,3505147,0,3505147,0
"N","!07198400079",1983,"COLEMAN NFH",0,0,19480,0,19480,0
"N","!07197600125",1974,"COLEMAN NFH",0,0,10085,0,10085,0
"N","!07197600129",1975,"COLEMAN NFH",0,0,3000,0,3000,0
"N","!07197600130",1975,"COLEMAN NFH",0,0,105723,0,105723,0
"N","!07197600131",1975,"COLEMAN NFH",0,0,13500,0,13500,0
"N","!07199500153",1994,"COLEMAN NFH",0,0,991674,0,991674,0
"N","!07199500154",1994,"COLEMAN NFH",0,0,1140084,0,1140084,0
"N","!07199500155",1994,"COLEMAN NFH",0,0,297373,0,297373,0
"N","!07199500156",1994,"COLEMAN NFH",0,0,177473,0,177473,0
"N","!07199500157",1994,"COLEMAN NFH",0,0,844457,0,844457,0
"N","!07199500158",1994,"COLEMAN NFH",0,0,217510,0,217510,0
"N","!07199500159",1994,"COLEMAN NFH",0,0,856320,0,856320,0
"N","!07199500166",1994,"COLEMAN NFH",0,0,490741,0,490741,0
"N","!07200000129",1999,"COLEMAN NFH",0,0,1150,0,1150,0
"T","56599",2021,"COLEMAN NFH",99350,0,241,307599,407190,0.24398929246789
"T","56601",2021,"COLEMAN NFH",100190,0,300843,0,401033,0.249829814504043
"T","56603",2021,"COLEMAN NFH",83509,0,251597,0,335106,0.249201745119455
"T","56604",2021,"COLEMAN NFH",121127,0,364598,0,485725,0.249373616758454
"T","56605",2021,"COLEMAN NFH",104748,0,267,314095,419110,0.249929612750829
"T","56606",2021,"COLEMAN NFH",97031,0,242,290568,387841,0.25018242011546
"T","56607",2021,"COLEMAN NFH",111449,0,333124,0,444573,0.250687738571618
"T","56608",2021,"COLEMAN NFH",104345,0,264,313036,417645,0.24984137245747
"T","56610",2021,"COLEMAN NFH",111647,0,334903,0,446550,0.250021274213414
"T","56611",2021,"COLEMAN NFH",104798,0,313573,0,418371,0.250490593277259
"T","56618",2021,"COLEMAN NFH",100340,0,1556,303710,405606,0.24738292826043
"T","56619",2021,"COLEMAN NFH",99794,0,494,293418,393706,0.253473404012131
"T","501040907",2007,"COLEMAN NFH",24953,126,126,0,25205,0.990001983733386
"T","501040908",2007,"COLEMAN NFH",24853,0,769,0,25622,0.969986730153774
"T","54391",2007,"COLEMAN NFH",111161,0,333857,0,445018,0.249789896139033
"T","54395",2007,"COLEMAN NFH",109247,0,327938,0,437185,0.249887347461601
"T","54397",2007,"COLEMAN NFH",109178,0,1694,332891,443763,0.246027722004764
"T","54469",2007,"COLEMAN NFH",224293,0,270,674107,898670,0.249583273059076
"T","54470",2007,"COLEMAN NFH",221255,0,2373,671381,895009,0.247209804594144
"T","501030603",2000,"COLEMAN NFH",61754,637,1273,377423,441087,0.140004126170121
"T","501030604",2000,"COLEMAN NFH",62325,1615,646,461579,526165,0.11845143633651
"T","501030605",2000,"COLEMAN NFH",61099,317,1899,364041,427356,0.142969795673864
"T","501030606",2000,"COLEMAN NFH",63265,324,1298,381568,446455,0.141705211051506
"T","501030607",2000,"COLEMAN NFH",63677,322,322,392835,457156,0.139289432928803
"T","501030608",2000,"COLEMAN NFH",63266,963,321,395657,460207,0.137472919794788
"T","50573",2000,"COLEMAN NFH",64110,0,1644,394301,460055,0.139352903457195
"T","50568",2000,"COLEMAN NFH",65645,330,381631,0,447606,0.146657998328887
"T","50565",2000,"COLEMAN NFH",64185,326,326,381390,446227,0.14383934634166
"T","50572",2000,"COLEMAN NFH",65502,0,366053,0,431555,0.151781348843137
"T","50571",2000,"COLEMAN NFH",65463,0,404974,0,470437,0.13915359548675
"T","50567",2000,"COLEMAN NFH",62403,0,2219,363366,427988,0.145805489873548
"T","50569",2000,"COLEMAN NFH",65355,0,347310,0,412665,0.158373014430591
"T","50498",2000,"COLEMAN NFH",65412,0,315,412521,478248,0.136774225924625
"T","50564",2000,"COLEMAN NFH",58822,0,377443,0,436265,0.13483089406668
"T","50499",2000,"COLEMAN NFH",62110,0,2322,317267,381699,0.162719839454649
"T","50497",2000,"COLEMAN NFH",65275,0,610,295989,361874,0.18038046391838
"T","501030507",2000,"COLEMAN NFH",59109,0,3440,371255,433804,0.136257388129201
"T","B61401",1987,"COLEMAN NFH",48280,0,5967,0,54247,0.890003133813851
"T","51940",1987,"COLEMAN NFH",52796,0,479,0,53275,0.991008916001877
"T","501030504",2000,"COLEMAN NFH",62298,1631,1305,381396,446630,0.139484584555449
"T","501030505",2000,"COLEMAN NFH",61379,2261,969,363975,428584,0.143213465738338
"T","501030506",2000,"COLEMAN NFH",62634,969,969,461771,526343,0.11899844778025
"T","501030105",2000,"COLEMAN NFH",49447,0,753,0,50200,0.985
"T","501030501",2000,"COLEMAN NFH",46413,0,4036,0,50449,0.919998414240124
"T","501021515",2000,"COLEMAN NFH",46944,505,2776,252,50477,0.930007726291182
"T","52818",1991,"COLEMAN NFH",49373,0,5183,0,54556,0.904996700637877
"T","501011204",1994,"COLEMAN NFH",46730,0,3680,0,50410,0.92699861138663
"T","501010908",1993,"COLEMAN NFH",49422,0,4769,0,54191,0.911996456976251
"T","501010310",1991,"COLEMAN NFH",55053,0,4787,0,59840,0.920003342245989
"T","501021310",1999,"COLEMAN NFH",11072,0,833,0,11905,0.930029399412012
"T","52038",1988,"COLEMAN NFH",52677,0,1020,0,53697,0.98100452539248
"T","501020101",1999,"COLEMAN NFH",47098,488,1220,0,48806,0.965004302749662
"T","501010111",1990,"COLEMAN NFH",51139,0,2578,0,53717,0.952007744289517
"T","501020410",1998,"COLEMAN NFH",10990,0,702,0,11692,0.93995894628806
"T","501010909",1993,"COLEMAN NFH",52860,0,4224,0,57084,0.926003783897414
"T","501010112",1990,"COLEMAN NFH",64118,0,582,0,64700,0.991004636785162
"T","501020606",1997,"COLEMAN NFH",33413,0,409604,3713,446730,0.0747946186734717
"T","501020615",1997,"COLEMAN NFH",33286,0,416058,4539,453883,0.0733360800029964
"T","52037",1988,"COLEMAN NFH",51074,0,1096,0,52170,0.978991757715162
"T","501020704",1997,"COLEMAN NFH",35534,0,440845,1870,478249,0.0743002076324258
"T","51939",1987,"COLEMAN NFH",51923,0,844,0,52767,0.984005154736862
"T","501020703",1997,"COLEMAN NFH",32007,0,433879,5210,471096,0.0679415660502318
"T","501020511",1997,"COLEMAN NFH",35122,0,417786,2644,455552,0.0770976749086822
"T","501020404",1996,"COLEMAN NFH",35000,0,1458,0,36458,0.960008777223106
"T","501021401",1999,"COLEMAN NFH",32504,1264,2348,501038,537154,0.0605115106654702
"T","501021011",1998,"COLEMAN NFH",31306,2578,2946,456079,492909,0.0635127376452854
"T","501021409",1999,"COLEMAN NFH",34381,181,1629,415607,451798,0.0760981677652402
"T","501020612",1997,"COLEMAN NFH",28585,0,412847,9027,450459,0.063457495576734
"T","501020611",1997,"COLEMAN NFH",28307,0,395884,7984,432175,0.0654989298316654
"T","501020705",1997,"COLEMAN NFH",34922,0,614145,2629,651696,0.0535863347327588
"T","501021403",1999,"COLEMAN NFH",34264,1269,725,427465,463723,0.0738889380082506
"T","501010804",1992,"COLEMAN NFH",56131,0,5484,0,61615,0.910995699099245
"T","56620",2021,"COLEMAN NFH",98726,0,318117,0,416843,0.236842168394336
"T","56621",2021,"COLEMAN NFH",112153,280,336906,0,449339,0.249595516970483
"T","501020514",1997,"COLEMAN NFH",34610,0,875746,1822,912178,0.037942156026565
"T","501020605",1997,"COLEMAN NFH",30971,0,402015,6798,439784,0.070423207756535
"T","501020601",1997,"COLEMAN NFH",37067,0,184270,374,221711,0.16718611164985
"T","501020603",1997,"COLEMAN NFH",33701,0,400043,2930,436674,0.0771765665004099
"T","501021106",1998,"COLEMAN NFH",32241,777,5827,434152,472997,0.0681632230225562
"T","501021013",1998,"COLEMAN NFH",34037,187,3179,458054,495457,0.0686981917704261
"T","501010805",1992,"COLEMAN NFH",59440,0,2541,0,61981,0.959003565608816
"T","501021103",1998,"COLEMAN NFH",33101,946,3783,436353,474183,0.0698063827678344
"T","501021314",1999,"COLEMAN NFH",35184,0,1852,459150,496186,0.0709088930360792
"T","53429",1993,"COLEMAN NFH",52483,0,4072,0,56555,0.927999292723897
"T","51941",1987,"COLEMAN NFH",52771,0,265,0,53036,0.99500339392111
"T","51845",1990,"COLEMAN NFH",12474,0,608,0,13082,0.953523926005198
"T","51848",1990,"COLEMAN NFH",20792,0,1012,0,21804,0.953586497890295
"T","52057",1989,"COLEMAN NFH",52077,0,633,0,52710,0.987990893568583
"T","52819",1991,"COLEMAN NFH",53332,0,812,0,54144,0.985002955082742
"T","51847",1990,"COLEMAN NFH",18713,0,911,0,19624,0.953577252344069
"T","51841",1986,"COLEMAN NFH",51271,0,309,0,51580,0.994009305932532
"T","501021202",1998,"COLEMAN NFH",36487,0,183,286156,322826,0.113023734147807
"T","501021407",1999,"COLEMAN NFH",34789,541,721,413697,449748,0.0773522061243185
"T","53904",1984,"COLEMAN NFH",11484,0,139,0,11623,0.988040953282285
"T","52814",1991,"COLEMAN NFH",53886,0,821,0,54707,0.984992779717404
"T","501021111",1998,"COLEMAN NFH",36099,0,926,440643,477668,0.0755734108209049
"T","53428",1993,"COLEMAN NFH",53430,0,3653,0,57083,0.936005465725347
"T","53427",1993,"COLEMAN NFH",54892,0,1350,0,56242,0.975996586181146
"T","501021508",1999,"COLEMAN NFH",36126,0,313,404600,441039,0.0819111235060845
"T","501020702",1997,"COLEMAN NFH",31762,0,417399,6050,455211,0.0697742365628247
"T","501021110",1998,"COLEMAN NFH",34689,183,1643,439920,476435,0.072809512315426
"T","H50401",1984,"COLEMAN NFH",23045,0,494,0,23539,0.979013551977569
"T","52813",1991,"COLEMAN NFH",49507,0,4540,0,54047,0.915999037874443
"T","501021104",1998,"COLEMAN NFH",32280,922,3689,437292,474183,0.0680749837088213
"T","501011208",1994,"COLEMAN NFH",50718,0,0,0,50718,1
"T","501010803",1992,"COLEMAN NFH",59697,0,664,0,60361,0.98899951955733
"T","501020610",1997,"COLEMAN NFH",27447,0,403771,9644,440862,0.0622575772010289
"T","H50403",1985,"COLEMAN NFH",28659,0,675,0,29334,0.976989159337288
"T","501020604",1997,"COLEMAN NFH",29548,0,407980,7855,445383,0.0663429003801223
"T","501021402",1999,"COLEMAN NFH",34176,723,1266,413388,449553,0.0760221820341539
"T","501021413",1999,"COLEMAN NFH",34002,723,1447,412345,448517,0.0758098355246289
"T","501021410",1999,"COLEMAN NFH",32814,363,3082,423787,460046,0.0713276498437113
"T","501020701",1997,"COLEMAN NFH",35032,0,409871,2637,447540,0.0782768020735577
"T","54104",1984,"COLEMAN NFH",10330,0,125,0,10455,0.98804399808704
"T","501021008",1998,"COLEMAN NFH",22091,2373,12050,431873,468387,0.0471639904608796
"T","501021414",1999,"COLEMAN NFH",35047,182,1090,180847,217166,0.16138345781568
"T","501021501",1999,"COLEMAN NFH",33860,362,1992,436172,472386,0.0716786695626035
"T","56609",2021,"COLEMAN NFH",94727,0,283869,0,378596,0.250206024363702
"T","501021411",1999,"COLEMAN NFH",34306,359,1257,349609,385531,0.0889837652484495
"T","51839",1986,"COLEMAN NFH",51706,0,208,0,51914,0.995993373656432
"T","501020509",1997,"COLEMAN NFH",35715,0,411789,1880,449384,0.0794754597404447
"T","501021502",1999,"COLEMAN NFH",34076,725,1450,417974,454225,0.0750200891628598
"T","501021412",1999,"COLEMAN NFH",35099,0,1086,413185,449370,0.0781071277566371
"T","501021415",1999,"COLEMAN NFH",32609,725,2899,451004,487237,0.0669263623247003
"T","501021010",1998,"COLEMAN NFH",28507,1386,9700,406563,446156,0.0638946915428684
"T","601141102",1992,"COLEMAN NFH",28361,0,315,0,28676,0.989015204352071
"T","501021504",1999,"COLEMAN NFH",34174,723,1266,383749,419912,0.0813837184933986
"T","501021503",1999,"COLEMAN NFH",34616,362,1269,413032,449279,0.0770478922896463
"T","501021506",1999,"COLEMAN NFH",34703,361,1084,320317,356465,0.0973531763286718
"T","501021201",1998,"COLEMAN NFH",36332,559,373,415327,452591,0.080275568891118
"T","501021406",1999,"COLEMAN NFH",33366,902,1804,410954,447026,0.074639953828189
"T","501021408",1999,"COLEMAN NFH",33500,720,1801,425331,461352,0.0726126688515494
"T","501021505",1999,"COLEMAN NFH",34195,731,1646,384421,420993,0.0812246284380025
"T","50616",1984,"COLEMAN NFH",10209,0,124,0,10333,0.987999612890738
"T","501010113",1990,"COLEMAN NFH",64373,0,325,0,64698,0.994976660793224
"T","501021107",1998,"COLEMAN NFH",34328,557,2227,440537,477649,0.0718686734401203
"T","501020508",1997,"COLEMAN NFH",32198,0,411186,5682,449066,0.071699928295618
"T","501020602",1997,"COLEMAN NFH",32511,0,409114,4858,446483,0.0728157623022601
"T","501020510",1997,"COLEMAN NFH",36747,0,417879,1136,455762,0.0806276082692282
"T","54004",1984,"COLEMAN NFH",10698,0,130,0,10828,0.987994089397857
"T","501021113",1998,"COLEMAN NFH",36166,0,182,443915,480263,0.0753045727028732
"T","52039",1988,"COLEMAN NFH",50842,0,514,0,51356,0.989991432354545
"T","501021102",1998,"COLEMAN NFH",32721,2445,2445,406437,444048,0.0736879796778727
"T","501011207",1994,"COLEMAN NFH",50036,0,0,0,50036,1
"T","501021014",1998,"COLEMAN NFH",34171,188,3192,457906,495457,0.0689686491461418
"T","H50707",1985,"COLEMAN NFH",51371,0,2029,0,53400,0.962003745318352
"T","501021007",1998,"COLEMAN NFH",24239,1814,8574,419349,453976,0.0533926903624861
"T","501021009",1998,"COLEMAN NFH",28376,1379,9656,406745,446156,0.0636010722706856
"T","H50105",1984,"COLEMAN NFH",22558,0,274,0,22832,0.987999299229152
"T","501021105",1998,"COLEMAN NFH",30240,729,5465,436562,472996,0.0639328873817115
"T","501021012",1998,"COLEMAN NFH",31228,2572,2939,456170,492909,0.0633544934257642
"T","501020613",1997,"COLEMAN NFH",28682,0,409542,9058,447282,0.0641250933415608
"T","501021109",1998,"COLEMAN NFH",37875,0,971,199820,238666,0.158694577359155
"T","501020513",1997,"COLEMAN NFH",35600,0,405149,1101,441850,0.0805703292972728
"T","B50413",1986,"COLEMAN NFH",51075,0,3318,0,54393,0.938999503612597
"T","501020515",1997,"COLEMAN NFH",37000,0,184337,374,221711,0.166883916449793
"T","501020315",1996,"COLEMAN NFH",34680,0,1073,0,35753,0.969988532430845
"T","501021108",1998,"COLEMAN NFH",37763,0,968,199935,238666,0.158225302305314
"T","501021405",1999,"COLEMAN NFH",33380,1451,1451,414470,450752,0.074054025273321
"T","501020614",1997,"COLEMAN NFH",30741,0,411455,6748,448944,0.0684740190313268
"T","501021015",1998,"COLEMAN NFH",29997,573,6305,889143,926018,0.0323935387865031
"T","56612",2021,"COLEMAN NFH",112142,0,593,337345,450080,0.24916014930679
"T","56613",2021,"COLEMAN NFH",106436,0,318896,0,425332,0.250242163768538
"T","56614",2021,"COLEMAN NFH",104750,0,314236,0,418986,0.250008353501072
"T","56622",2021,"COLEMAN NFH",111910,0,337527,0,449437,0.249000416076113
"T","56602",2021,"COLEMAN NFH",105806,0,317850,0,423656,0.249745076193893
"T","56628",2021,"COLEMAN NFH",86568,437,437,0,87442,0.990004803183825
"T","56615",2021,"COLEMAN NFH",94529,0,2299,289322,386150,0.244798653373042
"T","56616",2021,"COLEMAN NFH",109958,0,934,331823,442715,0.248371977457281
"T","56617",2021,"COLEMAN NFH",94955,0,1731,290101,386787,0.245496875541319
"T","56623",2021,"COLEMAN NFH",108957,0,554,327289,436800,0.249443681318681
"T","56624",2021,"COLEMAN NFH",109067,0,275,321138,430480,0.253361364058725
"T","56625",2021,"COLEMAN NFH",103188,0,2827,317912,423927,0.243409832353212
"T","56626",2021,"COLEMAN NFH",111360,0,896,336995,449251,0.247879247903733
"T","56627",2021,"COLEMAN NFH",112588,0,1478,358335,472401,0.238331417588024
"T","56629",2021,"COLEMAN NFH",84123,0,2615,436,87174,0.965001032417923
"T","56630",2021,"COLEMAN NFH",82448,850,850,0,84148,0.979797499643485
"T","56631",2021,"COLEMAN NFH",78320,402,1205,401,80328,0.975002489791853
"N","!0720211202",2021,"COLEMAN NFH",0,0,615426,0,615426,0
"N","!0720211203",2021,"COLEMAN NFH",0,0,635998,0,635998,0
"N","!0720220101",2021,"COLEMAN NFH",0,0,607605,0,607605,0
"T","H50106",1984,"COLEMAN NFH",23378,0,453,0,23831,0.98099114598632
"T","H50207",1979,"COLEMAN NFH",21624,0,5272,0,26896,0.803985722784057
"T","H50406",1985,"COLEMAN NFH",23669,0,293,0,23962,0.987772306151406
"T","H50306",1979,"COLEMAN NFH",21836,0,3321,0,25157,0.867989028898517
"T","50948",1984,"COLEMAN NFH",21943,0,289,0,22232,0.987000719683339
"T","H50405",1985,"COLEMAN NFH",27606,0,364,0,27970,0.986986056489095
"T","H50301",1979,"COLEMAN NFH",25618,0,2534,0,28152,0.909988633134413
"T","50949",1984,"COLEMAN NFH",20460,0,269,0,20729,0.987023011240291
"T","H50107",1984,"COLEMAN NFH",23519,0,310,0,23829,0.986990641655126
"T","H50305",1979,"COLEMAN NFH",21786,0,4336,0,26122,0.834009647040808
"T","H50303",1979,"COLEMAN NFH",23908,0,4219,0,28127,0.850001777651367
"T","H50206",1979,"COLEMAN NFH",22121,0,5393,0,27514,0.803990695645853
"T","54204",1984,"COLEMAN NFH",10610,0,206,0,10816,0.980954142011834
"T","H50407",1985,"COLEMAN NFH",22719,0,276,0,22995,0.987997390737117
"T","51842",1987,"COLEMAN NFH",51651,0,1270,0,52921,0.976001965193401
"T","501010104",1990,"COLEMAN NFH",43750,0,5427,0,49177,0.889643532545702
"T","52830",1991,"COLEMAN NFH",54055,0,823,0,54878,0.985003097780531
"T","52058",1989,"COLEMAN NFH",52446,0,370,0,52816,0.992994547106937
"T","55694",2013,"COLEMAN NFH",107940,0,325194,0,433134,0.249206942886035
"T","55695",2013,"COLEMAN NFH",108496,0,326477,0,434973,0.249431573913783
"T","55696",2013,"COLEMAN NFH",113008,0,549,341848,455405,0.248148351467375
"T","55697",2013,"COLEMAN NFH",208978,0,627515,0,836493,0.249826358379568
"T","55698",2013,"COLEMAN NFH",196513,0,590053,0,786566,0.24983663163676
"T","55699",2013,"COLEMAN NFH",215501,0,647090,0,862591,0.249829873022093
"T","55704",2013,"COLEMAN NFH",216603,0,650828,0,867431,0.249706316698389
"T","55705",2013,"COLEMAN NFH",207787,527,2108,634127,844549,0.246033089850322
"T","55706",2013,"COLEMAN NFH",213633,0,1048,645265,859946,0.248426063962156
"T","55707",2013,"COLEMAN NFH",315997,0,948620,0,1264617,0.24987565405178
"T","55708",2013,"COLEMAN NFH",304012,0,913134,0,1217146,0.249774472413334
"T","55709",2013,"COLEMAN NFH",409680,0,1230177,0,1639857,0.249826661715015
"T","55795",2014,"COLEMAN NFH",115207,0,345862,0,461069,0.249869325415502
"T","55796",2014,"COLEMAN NFH",91680,0,275419,0,367099,0.249741895238069
"T","55797",2014,"COLEMAN NFH",102470,0,257,308467,411194,0.249201107020044
"T","55799",2014,"COLEMAN NFH",113039,0,339408,0,452447,0.249839207686204
"T","55804",2014,"COLEMAN NFH",109600,0,304,330097,440001,0.249090342976493
"T","55780",2014,"COLEMAN NFH",105661,266,318086,0,424013,0.249192831351869
"T","501040109",2003,"COLEMAN NFH",74407,755,378,327850,403390,0.184454250229307
"T","501030104",2003,"COLEMAN NFH",49815,0,250,0,50065,0.995006491560971
"N","!07190000105",1999,"COLEMAN NFH",0,0,0,0,0,NA
"N","!07190000109",1999,"COLEMAN NFH",0,0,0,0,0,NA
"N","!07190000110",1999,"COLEMAN NFH",0,0,0,0,0,NA
"N","!07190000111",1999,"COLEMAN NFH",0,0,0,0,0,NA
"N","!07200400051",2003,"COLEMAN NFH",0,0,5477399,0,5477399,0
"N","!07200400052",2003,"COLEMAN NFH",0,0,6614040,0,6614040,0
"T","501020110",2004,"COLEMAN NFH",21369,0,109,0,21478,0.994925039575379
"N","!07200500401",2004,"COLEMAN NFH",0,0,6097731,0,6097731,0
"N","!07200500402",2004,"COLEMAN NFH",0,0,5609155,0,5609155,0
"N","!07199900208",1998,"COLEMAN NFH",0,0,3510,0,3510,0
"T","501040108",2003,"COLEMAN NFH",67636,0,338471,0,406107,0.1665472400131
"T","501030103",2003,"COLEMAN NFH",50196,0,0,0,50196,1
"N","!07200600401",2005,"COLEMAN NFH",0,0,6600075,0,6600075,0
"T","501040707",2005,"COLEMAN NFH",24297,0,623,0,24920,0.975
"T","501040708",2005,"COLEMAN NFH",24124,0,649,0,24773,0.973802123279377
"T","501040709",2005,"COLEMAN NFH",25275,0,255,0,25530,0.990011750881316
"T","501040703",2005,"COLEMAN NFH",24123,0,367,0,24490,0.98501429154757
"T","501040807",2006,"COLEMAN NFH",25761,0,392,0,26153,0.985011279776699
"T","53798",2006,"COLEMAN NFH",64093,0,1870,146301,212264,0.30194945916406
"T","501040804",2006,"COLEMAN NFH",23745,649,1557,0,25951,0.914993641863512
"N","!0720070402",2006,"COLEMAN NFH",0,0,1,0,1,0
"T","501040801",2006,"COLEMAN NFH",22756,0,948,0,23704,0.960006749915626
"T","501040802",2006,"COLEMAN NFH",24560,0,0,0,24560,1
"T","501040803",2006,"COLEMAN NFH",25800,130,0,0,25930,0.994986502121095
"T","501040805",2006,"COLEMAN NFH",24624,0,1160,0,25784,0.955010859447719
"T","501040806",2006,"COLEMAN NFH",24698,0,376,0,25074,0.985004387014437
"T","501040808",2006,"COLEMAN NFH",24164,0,1272,0,25436,0.949992137128479
"N","!0720070401",2006,"COLEMAN NFH",0,0,1,0,1,0
"T","53794",2006,"COLEMAN NFH",1278401,0,3825433,0,5103834,0.250478561802755
"T","53795",2006,"COLEMAN NFH",1432683,0,1856,4252400,5686939,0.251925156925369
"T","53796",2006,"COLEMAN NFH",64885,0,783,171202,236870,0.273926626419555
"T","53797",2006,"COLEMAN NFH",46377,0,560,189933,236870,0.195790940178157
"T","53799",2006,"COLEMAN NFH",39208,0,1144,171912,212264,0.184713375796178
"T","53864",2006,"COLEMAN NFH",64665,0,544,147071,212280,0.304621254946297
"T","54887",2008,"COLEMAN NFH",115967,0,348232,0,464199,0.249821735936527
"T","54870",2008,"COLEMAN NFH",126145,0,378820,0,504965,0.249809392730189
"T","54871",2008,"COLEMAN NFH",137800,353,353,415712,554218,0.248638622347163
"T","54872",2008,"COLEMAN NFH",119391,0,358513,0,477904,0.249822140011383
"T","54873",2008,"COLEMAN NFH",129807,0,389689,0,519496,0.24987102884334
"T","54874",2008,"COLEMAN NFH",118116,0,354644,0,472760,0.249843472374989
"T","54875",2008,"COLEMAN NFH",112979,0,339299,0,452278,0.24979990183029
"T","54876",2008,"COLEMAN NFH",105755,0,317638,0,423393,0.249779755451791
"T","54877",2008,"COLEMAN NFH",108337,0,325459,0,433796,0.249741814124612
"T","54878",2008,"COLEMAN NFH",118706,0,356319,0,475025,0.24989421609389
"T","54879",2008,"COLEMAN NFH",107781,0,267,324437,432485,0.249213267512168
"T","54880",2008,"COLEMAN NFH",119514,0,358696,0,478210,0.249919491436816
"T","54882",2008,"COLEMAN NFH",118755,0,306,357300,476361,0.249296227021104
"T","54883",2008,"COLEMAN NFH",108863,0,326820,0,435683,0.249867449498833
"T","54884",2008,"COLEMAN NFH",115782,0,287,348496,464565,0.249226695941365
"T","54885",2008,"COLEMAN NFH",114739,0,344500,0,459239,0.249845940784646
"T","54886",2008,"COLEMAN NFH",109292,0,271,328915,438478,0.249253098217014
"T","54888",2008,"COLEMAN NFH",124628,312,375046,0,499986,0.249262979363422
"T","54889",2008,"COLEMAN NFH",113350,0,340285,0,453635,0.249870490592657
"T","54890",2008,"COLEMAN NFH",109171,0,327691,0,436862,0.249898137169175
"T","54892",2008,"COLEMAN NFH",120927,0,315,363879,485121,0.249271831151403
"T","54893",2008,"COLEMAN NFH",118917,0,357073,0,475990,0.249830878799975
"T","55182",2009,"COLEMAN NFH",86302,215,260628,0,347145,0.248605049763067
"T","55188",2009,"COLEMAN NFH",117670,0,311,355427,473408,0.248559382181966
"T","55195",2009,"COLEMAN NFH",112693,788,1182,347451,462114,0.243864068173654
"T","55223",2009,"COLEMAN NFH",101711,0,305381,0,407092,0.249847700274139
"T","55196",2009,"COLEMAN NFH",105240,0,316941,0,422181,0.249276968883015
"T","55198",2009,"COLEMAN NFH",103920,0,0,311941,415861,0.249891189604219
"T","55193",2009,"COLEMAN NFH",117720,0,0,353357,471077,0.249895452335818
"T","55179",2009,"COLEMAN NFH",95975,231,463,291424,388093,0.247298972153582
"T","55180",2009,"COLEMAN NFH",88137,0,0,265541,353678,0.249201250855298
"T","55181",2009,"COLEMAN NFH",95007,244,286921,0,382172,0.248597490135332
"T","55183",2009,"COLEMAN NFH",116291,282,0,349904,466477,0.249296321147666
"T","55184",2009,"COLEMAN NFH",114091,0,347008,0,461099,0.24743276389669
"T","55185",2009,"COLEMAN NFH",108389,0,0,325252,433641,0.249950996331066
"T","55186",2009,"COLEMAN NFH",105794,0,0,317531,423325,0.249912006141853
"T","55187",2009,"COLEMAN NFH",118588,309,356835,0,475732,0.249274801779153
"T","55189",2009,"COLEMAN NFH",112440,0,0,337542,449982,0.249876661733136
"T","55190",2009,"COLEMAN NFH",99672,0,0,304467,404139,0.24662801659825
"T","55191",2009,"COLEMAN NFH",104281,0,0,313051,417332,0.249875398962936
"T","55192",2009,"COLEMAN NFH",116800,0,0,350569,467369,0.249909600337207
"T","55194",2009,"COLEMAN NFH",111590,0,0,336094,447684,0.249260639200865
"T","55197",2009,"COLEMAN NFH",107617,0,0,323139,430756,0.249832852009026
"T","55199",2009,"COLEMAN NFH",99659,0,0,300079,399738,0.249310798573065
"T","55221",2009,"COLEMAN NFH",109482,0,550,330261,440293,0.248657144219872
"T","55222",2009,"COLEMAN NFH",110067,0,788,332792,443647,0.248095896061508
"T","55224",2009,"COLEMAN NFH",94403,0,243,285087,379733,0.248603624125372
"T","55225",2009,"COLEMAN NFH",90698,0,0,272183,362881,0.249938685133694
"T","55226",2009,"COLEMAN NFH",89598,0,224,269640,359462,0.2492558323272
"T","55227",2009,"COLEMAN NFH",45226,0,578,137546,183350,0.246664848650123
"T","55384",2010,"COLEMAN NFH",119435,0,358570,0,478005,0.249861403123398
"T","55369",2010,"COLEMAN NFH",107520,0,284,323679,431483,0.249187105865121
"T","55370",2010,"COLEMAN NFH",114941,0,345289,0,460230,0.249746865697586
"T","55371",2010,"COLEMAN NFH",102080,0,306520,0,408600,0.24982868330886
"T","55372",2010,"COLEMAN NFH",107843,0,323813,0,431656,0.249835517171081
"T","55373",2010,"COLEMAN NFH",116619,0,350064,0,466683,0.249889111023971
"T","55374",2010,"COLEMAN NFH",113603,0,633,342919,457155,0.248499961719767
"T","55375",2010,"COLEMAN NFH",116346,0,349196,0,465542,0.24991515266077
"T","55376",2010,"COLEMAN NFH",112097,0,336585,0,448682,0.249836186876229
"T","55377",2010,"COLEMAN NFH",114891,236,59,346589,461775,0.24880298846841
"T","55381",2010,"COLEMAN NFH",113938,578,289,347004,461809,0.246721047012943
"T","55382",2010,"COLEMAN NFH",102858,481,311437,0,414776,0.247984454259649
"T","55383",2010,"COLEMAN NFH",101916,0,305862,0,407778,0.249930109029913
"T","55385",2010,"COLEMAN NFH",116099,0,348473,0,464572,0.249905289169386
"T","55386",2010,"COLEMAN NFH",116363,0,349515,0,465878,0.249771399379237
"T","55387",2010,"COLEMAN NFH",109050,0,327457,0,436507,0.249824172350043
"T","55388",2010,"COLEMAN NFH",111886,0,335955,0,447841,0.249834204550276
"T","55389",2010,"COLEMAN NFH",120305,0,299,362276,482880,0.249140573227303
"T","55390",2010,"COLEMAN NFH",118874,0,603,358670,478147,0.24861391998695
"T","55392",2010,"COLEMAN NFH",114286,0,343152,0,457438,0.249839322487419
"T","55393",2010,"COLEMAN NFH",119307,834,360676,0,480817,0.248133905415158
"T","55394",2010,"COLEMAN NFH",110103,0,330610,0,440713,0.249829253958926
"T","55395",2010,"COLEMAN NFH",122856,0,368790,0,491646,0.249887113899025
"T","55396",2010,"COLEMAN NFH",117642,0,353084,0,470726,0.249916087065512
"T","55391",2010,"COLEMAN NFH",118990,0,357168,0,476158,0.249896042910126
"T","55505",2011,"COLEMAN NFH",115185,0,345817,0,461002,0.249857918186906
"T","55506",2011,"COLEMAN NFH",101112,0,303721,0,404833,0.249762247642855
"T","55495",2011,"COLEMAN NFH",120615,112,307,363770,484804,0.248791264098481
"T","55521",2011,"COLEMAN NFH",110545,0,331877,0,442422,0.249863252731555
"T","55507",2011,"COLEMAN NFH",112234,0,336869,0,449103,0.249907036915808
"T","55525",2011,"COLEMAN NFH",116492,0,349705,0,466197,0.249877197836966
"T","55496",2011,"COLEMAN NFH",111444,103,284,336141,447972,0.24877447697624
"T","55497",2011,"COLEMAN NFH",106881,99,272,322357,429609,0.248786687429733
"T","55498",2011,"COLEMAN NFH",118364,110,301,357069,475844,0.248745387143686
"T","55499",2011,"COLEMAN NFH",117986,109,300,355863,474258,0.248780199806856
"T","55504",2011,"COLEMAN NFH",109094,0,327556,0,436650,0.24984312378335
"T","55508",2011,"COLEMAN NFH",117215,109,298,353540,471162,0.248778551750778
"T","55509",2011,"COLEMAN NFH",104717,97,267,316136,421217,0.24860582550087
"T","55510",2011,"COLEMAN NFH",120103,111,306,362263,482783,0.248772222717038
"T","55511",2011,"COLEMAN NFH",107344,99,273,323773,431489,0.248775750946142
"T","55512",2011,"COLEMAN NFH",104962,97,267,316520,421846,0.248815918605368
"T","55513",2011,"COLEMAN NFH",115993,0,999,351136,468128,0.247780521566751
"T","55515",2011,"COLEMAN NFH",116318,0,1002,352214,469534,0.247730728765116
"T","55516",2011,"COLEMAN NFH",93426,0,805,282885,377116,0.247738096500811
"T","55517",2011,"COLEMAN NFH",113261,0,596,341821,455678,0.248554900609641
"T","55518",2011,"COLEMAN NFH",96596,0,289966,0,386562,0.249884882632023
"T","55519",2011,"COLEMAN NFH",119684,0,359201,0,478885,0.249922215145599
"T","55520",2011,"COLEMAN NFH",111093,0,333472,0,444565,0.249891466939593
"T","55522",2011,"COLEMAN NFH",118451,0,355545,0,473996,0.249898733322644
"T","55523",2011,"COLEMAN NFH",126404,0,379458,0,505862,0.249878425341299
"T","55524",2011,"COLEMAN NFH",119849,0,359755,0,479604,0.249891577217871
"T","55526",2011,"COLEMAN NFH",107431,0,322443,0,429874,0.24991276513583
"N","!07201301150",2012,"COLEMAN NFH",0,0,1150,0,1150,0
